50
50
PPPPPPPPPPPPPPPPPPPPPPPPPPPPPPPPPPPPPPPPPPPPPPPPPP
PPPPPPPPPPPPPPPPPPPPPPPPPPPPPPPPPPPPPPPPPPPPPPPPPP
PPPPPPPPPPPPPPPPPPPPPPPPPPPPPPPPPPPPPPPPPPPPPPPPPP
PPPUUUUUUUUUUUUUUUUUUUUUUUUUUUUUUUUUUUUUUUUUUUUPPP
PPPUSCSCSCSCSCSCSCSCSCSCSCSCSCSCSCSCSCSCSCSCSCUPPP
PPPUCSCSCSCSCSCSCSCSCSCSCSCSCSCSCSCSCSCSCSCSCSUPPP
PPPUSCSCSCSCSCSCSCSCSCSCSCSCSCSCSCSCSCSCSCSCSCUPPP
PPPUCSCSCSCSCSCSCSCSCSCSCSCSCSCSCSCSCSCSCSCSCSUPPP
PPPUSCSCSCSCSCSCSCSCSCSCSCSCSCSCSCSCSCSCSCSCSCUPPP
PPPUCSCSCSCSCSCSCSCSCSCSCSCSCSCSCSCSCSCSCSCSCSUPPP
PPPUSCSCSCSCSCSCSCSCSCSCSCSCSCSCSCSCSCSCSCSCSCUPPP
PPPUCSCSCSCSCSCSCSCSCSCSCSCSCSCSCSCSCSCSCSCSCSUPPP
PPPUSCSCSCSCSCSCSCSCSCSCSCSCSCSCSCSCSCSCSCSCSCUPPP
PPPUCSCSCSCSCSCSCSCSCSCSCSCSCSCSCSCSCSCSCSCSCSUPPP
PPPUSCSCSCSCSCSCSCSCSCSCSCSCSCSCSCSCSCSCSCSCSCUPPP
PPPUCSCSCSCSCSCSCSCSCSCSCSCSCSCSCSCSCSCSCSCSCSUPPP
PPPUSCSCSCSCSCSCSCSCSCSCSCSCSCSCSCSCSCSCSCSCSCUPPP
PPPUCSCSCSCSCSCSCSCSCSCSCSCSCSCSCSCSCSCSCSCSCSUPPP
PPPUSCSCSCSCSCSCSCSCSCSCSCSCSCSCSCSCSCSCSCSCSCUPPP
PPPUCSCSCSCSCSCSCSCSCSCSCSCSCSCSCSCSCSCSCSCSCSUPPP
PPPUSCSCSCSCSCSCSCSCSCSCSCSCSCSCSCSCSCSCSCSCSCUPPP
PPPUCSCSCSCSCSCSCSCSCSCSCSCSCSCSCSCSCSCSCSCSCSUPPP
PPPUSCSCSCSCSCSCSCSCSCSCSCSCSCSCSCSCSCSCSCSCSCUPPP
PPPUCSCSCSCSCSCSCSCSCSCSCSCSCSCSCSCSCSCSCSCSCSUPPP
PPPUSCSCSCSCSCSCSCSCSCSCSCSCSCSCSCSCSCSCSCSCSCUPPP
PPPUCSCSCSCSCSCSCSCSCSCSCSCSCSCSCSCSCSCSCSCSCSUPPP
PPPUSCSCSCSCSCSCSCSCSCSCSCSCSCSCSCSCSCSCSCSCSCUPPP
PPPUCSCSCSCSCSCSCSCSCSCSCSCSCSCSCSCSCSCSCSCSCSUPPP
PPPUSCSCSCSCSCSCSCSCSCSCSCSCSCSCSCSCSCSCSCSCSCUPPP
PPPUCSCSCSCSCSCSCSCSCSCSCSCSCSCSCSCSCSCSCSCSCSUPPP
PPPUSCSCSCSCSCSCSCSCSCSCSCSCSCSCSCSCSCSCSCSCSCUPPP
PPPUCSCSCSCSCSCSCSCSCSCSCSCSCSCSCSCSCSCSCSCSCSUPPP
PPPUSCSCSCSCSCSCSCSCSCSCSCSCSCSCSCSCSCSCSCSCSCUPPP
PPPUCSCSCSCSCSCSCSCSCSCSCSCSCSCSCSCSCSCSCSCSCSUPPP
PPPUSCSCSCSCSCSCSCSCSCSCSCSCSCSCSCSCSCSCSCSCSCUPPP
PPPUCSCSCSCSCSCSCSCSCSCSCSCSCSCSCSCSCSCSCSCSCSUPPP
PPPUSCSCSCSCSCSCSCSCSCSCSCSCSCSCSCSCSCSCSCSCSCUPPP
PPPUCSCSCSCSCSCSCSCSCSCSCSCSCSCSCSCSCSCSCSCSCSUPPP
PPPUSCSCSCSCSCSCSCSCSCSCSCSCSCSCSCSCSCSCSCSCSCUPPP
PPPUCSCSCSCSCSCSCSCSCSCSCSCSCSCSCSCSCSCSCSCSCSUPPP
PPPUSCSCSCSCSCSCSCSCSCSCSCSCSCSCSCSCSCSCSCSCSCUPPP
PPPUCSCSCSCSCSCSCSCSCSCSCSCSCSCSCSCSCSCSCSCSCSUPPP
PPPUSCSCSCSCSCSCSCSCSCSCSCSCSCSCSCSCSCSCSCSCSCUPPP
PPPUCSCSCSCSCSCSCSCSCSCSCSCSCSCSCSCSCSCSCSCSCSUPPP
PPPUSCSCSCSCSCSCSCSCSCSCSCSCSCSCSCSCSCSCSCSCSCUPPP
PPPUCSCSCSCSCSCSCSCSCSCSCSCSCSCSCSCSCSCSCSCSCSUPPP
PPPUUUUUUUUUUUUUUUUUUUUUUUUUUUUUUUUUUUUUUUUUUUUPPP
PPPPPPPPPPPPPPPPPPPPPPPPPPPPPPPPPPPPPPPPPPPPPPPPPP
PPPPPPPPPPPPPPPPPPPPPPPPPPPPPPPPPPPPPPPPPPPPPPPPPP
PPPPPPPPPPPPPPPPPPPPPPPPPPPPPPPPPPPPPPPPPPPPPPPPPP
00000000000000000000000000000000000000000000000000
00000000000000000000000000000000000000000000000000
00000000000000000000000000000000000000000000000000
00054321012345432101234555543210123454321012345000
00045050505050505050505050505050505050505050504000
00030505050505050505050505050505050505050505053000
00025050505050505050505050505050505050505050502000
00010505050505050505050505050505050505050505051000
00005050505050505050505050505050505050505050500000
00010505050505050505050505050505050505050505051000
00025050505050505050505050505050505050505050502000
00030505050505050505050505050505050505050505053000
00045050505050505050505050505050505050505050504000
00050505050505050505050505050505050505050505055000
00045050505050505050505050505050505050505050504000
00030505050505050505050505050505050505050505053000
00025050505050505050505050505050505050505050502000
00010505050505050505050505050505050505050505051000
00005050505050505050505050505050505050505050500000
00010505050505050505050505050505050505050505051000
00025050505050505050505050505050505050505050502000
00030505050505050505050505050505050505050505053000
00045050505050505050505050505050505050505050504000
00050505050505050505050505050505050505050505055000
00055050505050505050505050505050505050505050505000
00050505050505050505050505050505050505050505055000
00055050505050505050505050505050505050505050505000
00040505050505050505050505050505050505050505054000
00035050505050505050505050505050505050505050503000
00020505050505050505050505050505050505050505052000
00015050505050505050505050505050505050505050501000
00000505050505050505050505050505050505050505050000
00015050505050505050505050505050505050505050501000
00020505050505050505050505050505050505050505052000
00035050505050505050505050505050505050505050503000
00040505050505050505050505050505050505050505054000
00055050505050505050505050505050505050505050505000
00040505050505050505050505050505050505050505054000
00035050505050505050505050505050505050505050503000
00020505050505050505050505050505050505050505052000
00015050505050505050505050505050505050505050501000
00000505050505050505050505050505050505050505050000
00015050505050505050505050505050505050505050501000
00020505050505050505050505050505050505050505052000
00035050505050505050505050505050505050505050503000
00040505050505050505050505050505050505050505054000
00054321012345432101234555543210123454321012345000
00000000000000000000000000000000000000000000000000
00000000000000000000000000000000000000000000000000
00000000000000000000000000000000000000000000000000
