30
30
PPPPPPPPPPPPPPPPPPPPPPPPPPPPPP
PPPPPPPPPPPPPPPPPPPPPPPPPPPPPP
PPPPPPPPPPPPPPPPPPPPPPPPPPPPPP
PPPHHHHHHCCCCCHHHHHHHCCCCCHPPP
PPPHHHHHHCHCHHHHHHHCCCHHHHPPPP
PPPHHHHHHCHCCCCCCCCCHCHHHHPPPP
PPPHHHHHHCCCCCHHHHHHHCCCCCHPPP
PPPHHHHHHHHHHCHHHHHHHHCHHHPPPP
PPPHHHHHHHHHHCHHHHHHHHCHHHPPPP
PPPHHHHHHHHHHCHHHHHHHHCHHHPPPP
PPPHHHHHHCCCCCHHHHHHCCCCCHPPPP
PPPHHHHHHCHCHHHHHHHCHCHHHHPPPP
PPPHHHHHHCHCHHHHHHHCHCHHHHPPPP
PPPHHHHHHCCCCCHHHHHHHCCCCCHPPP
PPPHHHHHHSSCSSHHHHHHHSCSSSHPPP
PPPHHHHHHSSCSSHHHHHHHSCSSSHPPP
PPPHHHHHHSSCSSHHHHHHHSCSSSHPPP
PPPHHHHHHSSCSSHHHHHHHSCSSSHPPP
PPPHHHHHHSSCSSHHHHHHHSCSSSHPPP
PPPCHHHHHHCCCCCHHHHHHHHCCCCPPP
PPPCCCCCCCCHCHHHHHHHHHCHHHCPPP
PPPCHHHHHHCHCHHHHHHHHHCHHUCPPP
PPPCUHHHHHCCCCCHHHHHHHHCCCCPPP
PPPAAAAAAHHHHHHHHHHHHHHHHAAPPP
PPPAAAAAAHHHHHHHHHHHHHHHHAAPPP
PPPAAAAAAHHHHHHHHHHHHHHHHAAPPP
PPPAAAAAAHHHHHHHHHHHHHHHHAAPPP
PPPPPPPPPPPPPPPPPPPPPPPPPPPPPP
PPPPPPPPPPPPPPPPPPPPPPPPPPPPPP
PPPPPPPPPPPPPPPPPPPPPPPPPPPPPP
000000000000000000000000000000
000000000000000000000000000000
000000000000000000000000000000
000222222211111122222111111000
000222222212111122222121111000
000222222212111122222121111000
000222222211111122222111111000
000222222222222222222222222000
000222222222222222222222222000
000222222222222222222222222000
000222222211111122222111111000
000222222212111122222121111000
000222222212111122222121111000
000222222211111122222111111000
000222222222232222222323222000
000222222223232222222323222000
000222222223232222222323222000
000222222223232222222323222000
000222222223232222222323222000
000222222223232222222323222000
000222222223232222222323222000
000222222223232222222323222000
000222222222232222222323222000
000222222211111122222111111000
000222222212111122222121111000
000222222212111122222121111000
000222222211111122222111111000
000000000000000000000000000000
000000000000000000000000000000
000000000000000000000000000000