100
100
PPPPPPPPPPPPPPPPPPPPPPPPPPPPPPPPPPPPPPPPPPPPPPPPPPPPPPPPPPPPPPPPPPPPPPPPPPPPPPPPPPPPPPPPPPPPPPPPPPPP
PPPPPPPPPPPPPPPPPPPPPPPPPPPPPPPPPPPPPPPPPPPPPPPPPPPPPPPPPPPPPPPPPPPPPPPPPPPPPPPPPPPPPPPPPPPPPPPPPPPP
PPPPPPPPPPPPPPPPPPPPPPPPPPPPPPPPPPPPPPPPPPPPPPPPPPPPPPPPPPPPPPPPPPPPPPPPPPPPPPPPPPPPPPPPPPPPPPPPPPPP
PPPHHHHHHHHHHHAAAHHHHHHHHHHHHHHHHHHHHHHHHHHMMMMMMCCMMMMMHHHHHHHHBBBBBBHHHHHHHHHHHHHHHHHHHAABBBBBBPPP
PPPHHHHHHHHHHHAAHHHHHHHHHHHHHHHHHHHHHHHHHMMMMMMMMDDMMMMMMHHHHHBBBBBBBBHHHHHHHHHHHHHHHHHHAAABBBBBBPPP
PPPHHHHHHHHHHAAAHHHHHHHHHHHHHHHHHHMMMMMMMMMMMMMMMDDMMMMMMMMMMMMMBBBBBBHHHHHHHHHHHHHHHHHHAABBBHBHHPPP
PPPHHHHHHHHHAAAHHHHHHHHHHHHHHHHHHHMMMMMMMMMCCCCCCCCCCCCMMMMMMMMMMBBBBBBHHHHHHHHHHHHHHHHAABBBBHBHHPPP
PPPHHHHHHHHHAAHHHHHHHHHHHHHHHHHHMMMMMMMMMMCCCCCCCCCCCCCCMMMMMMMMMMMBBBBBHHHHHHHHHHHHHHHAABBBBBBHHPPP
PPPHHHHHHHHAAAHHHHHHHHHHHHHHHHMMMMCCCCCCCCCCSSSSSCCSSSCCCCCCCCCCMMMMMMMBBHHHHHHHHHHHHHAABBBBBBBHHPPP
PPPHHHHHHHHAAHHHHHHHHHHHHHHHHMMMMMCCCCCSCSSSSSSSSCCSSSUUCCCCCCCCCMMMMMMMBHHHHHHHHHHHHHAABBBBBBHHHPPP
PPPHHHHHHHAAHHHHHHHHHHHHHHHMMMMMCCCSSSSSSSSSSSSSSCCSSSUUSSSSSSSCCCCCCMMMMMBBHHHHHHHHHHAABBBBHHHHHPPP
PPPHHHHHHHAAHHHHHHHHHHHHMMMMMMMCCSSSSSSSSSSSSSSSSCCSSSSSSSSSSSSSCCCCCCMMMMMBHHHHHHHHHHAABBBBBBHHHPPP
PPPHHHHHHHAAHHHHHHHHHHHMMMMMMCCCCSSSSSSSSSSSSSSSSCCSSSSSSSSSSSSSSSSCCCCMMMMMHHHHHHHHHHAABBBBBBBHHPPP
PPPHHHHHHAAAHHHHHHHHHHMMMMMCCCCSSSSSSSSSSSSSSSSSSCCSSSSSSSSSSSSSSSSSSCCCCMMMMHHHHHHHHHHABBBBBBBHHPPP
PPPHHHHHAAHHHHHHHHHHMMMMMMCCCCSSSSSSSSSSSSSSSSSSSCCSSSSSSSSSHHHHHSSSSSCCCCMMMMMBBHHHHHHAABBBBBBHHPPP
PPPHHHHAAAHHHHHHHHHMMMMMCCCSSSSSSSSSSSSSSSSSSSSSSCCSSSSSSSSSHHHHHSSSSSSCCCCMMMMMBBHHHHHAABBBBBBBHPPP
PPPHHHAAAHHHHHHHHHMMMMMCCCCSSSSSSSSSSSSSSSSSSSSSSCCSSSSSSSSSHSSSHSSSSSSSSCCCMMMMMBBHHHHHAABBBBBBHPPP
PPPHHAAAHHHHHHHHHMMMMMCCCCCSSSSSSSSSHHHHHSSSSSSSSCCSSSSSSSSSHSHSHSSSSSSSSCCCCMMMMMBBHHHHAAABBBBBHPPP
PPPHAAAHHHHHHHHHMMMMCCCCCCCCCSSSSSSSHHHHHSSSSSSHHCCHHSSSSSSDHSSSHSSSSSSSCCCCCCCMMMMBHHHHHAAABBBHHPPP
PPPAAAHHHHHHHHHHMMMMCCCSSCCCCSSSSSSSHSSSHSSSSSSHHCCHHSSSSSSSHHHHHSSSSSSSCCHHCCCCMMMMHHHHHHAABBBBHPPP
PPPAAHHHHHHHHHHMMMMCCCSSSSCCCCSSSSSSSSHSSSSSSSSSSCCHHSSSSSSSHHHHHSSSSSSCCCHHHCCCCMMMMHHHHHHAAABBBPPP
PPPAHHHHHHHHHHMMMMCCCSSSSSCCCCCSSSSSHSSSHSSSSSSSSCCHHSSSSSSSSSSSSSSSSSCCCSSHHHCCCCMMMMBBHHHBAABBBPPP
PPPHHHHHHHHHHMMMMCCCCSSSSSCCCCCSSSSSHHHHHSSSSSSSSCCHHSSSSSSSSSSSSSSSSSCCSSSSHHHCCCCMMMMBHHHBBAABBPPP
PPPHHHHHHHHHMMMMCCCHHSSSSSCCCCCCSSSSHHHHHSSSSSSSSCCSSSSSSSSSSSSSSSSSCCCSSSSSSHHSCCCCMMMBHHHHBBAABPPP
PPPHHHHHHHHMMMMCCCHHHSSSSSCCCCCCSSSSSSSSSSSSSSSSSCCSSSSSSSSSSSSSSSSSCCCSSSSSSSDSSCCCCMMMHHHHHBAABPPP
PPPHHHHHHHHMMMCCCHHHSSSSSSCCCCCCCSSSSSSSSSSSSSSHHCCHHSSSSSSSSSSSSSSCCCSSSSSSSSSSSSSCCCMMMHHHHBBAAPPP
PPPHHHHHHHHMMMCCCHHDSSSSSSSCCCCCCCSSSSSSSSSSSSHHHCCHHHSSSSSSSSSSSSCCCSSSSSSSSSSSSSSSCCCMMHHHHHBBBPPP
PPPHHHHHHMMMMCCCSSSSSSSSSSSSCCCCCCCSSSSSSSSSSHHHHCCHHHHSSSSSSSSSSSCCCSSSSSSSSSSSSSSSCCCMMMHHHHBBBPPP
PPPHHHHHHMMMCCCSSSSSSSSSSSSSSCCCCCCSSSSSSSSSSHHHCCCCHHHSSSSSSSSSSSCCSSSSSSSSSSSSSSSSSCCMMMMHHHHBBPPP
PPPHHHHHHMMMCCSSSSSSSSSSSSSSSHHCCCCCCSSSSSSSSHHHCBBCHHHSSSSSSSHHSCCSSSSSSSSSSSSSSSSSSCCMMMMMHHHBBPPP
PPPHHHHHMMMCCSSSSSSSSSSSSSSSSHHHCCCCCSSSSSSSSHHHCBBCHHHSSSSSSHHHCCCSSSSSSSSSSSSSSSSSSSCCCMMMHHHHBPPP
PPPHHHHHMMCCCSSSSSSSSSSSSSSSSHHHCCCCCSSSSSSSSHHHCCCCHHHSSSSSHHHCCCHHSSSSSSSSSSSSSSSSSSCCCCMMHHHHHPPP
PPPHHHHMMMCCSSSSSSSSSSSSSSSSSSSSSCCCCCSSSSSSSHHHHCCHHHHSSSSSHHHCCSHHSSSSSSSSSSSSSSSSSSSSCCMMMMHHHPPP
PPPHHHMMCCCSSSSSSSSSSSSSSSSSSSSSSCCCCCSSSSSSSSHHHCCHHHSDSSSSSHCCCSSSSSSSSSSSSSSSSSSSSSSSCCMMMMHHHPPP
PPPHHHMMCCCSSSSSSSSSSSSSSSSSSSSSHHCCCCCSSSSSSSSHHCCHHSSSSSSSSCCCSSSSSSSSSSSSSSSSSSSSSSSSCCCMDCHHHPPP
PPPHHHMMCCSSSSAAAAASSSSSSSSSSSSSHHCCCCCCSSSSSSSSSCCSSSSSSSSSCCSSSSSSSSSSSSSSSSSSSSSSSSSSSCCDDDCHHPPP
PPPHHHCDCCSSSSAAAAASSSSSSSSSSSSSSSSSCCCCCCSSSSSSSCCSSSSSSSSCCCSSSSSSSSSSSSSSSSSDAAAASSCCCCCCCDCHHPPP
PPPHHHCDCCCCCSSSSSDSSSSSSSSSSSSSSSSSCCCCCCSSSSSSSCCSSSSSSSSCCSSSSSSSSSSSSSSSSSSSAAAASSCCCCCCCMMMHPPP
PPPHHMDDCCCCCCCCSSSSSSSSSSSSSSSSSSSSSCCCCCCSSSSSSCCSSSSSSCCCCSSSSSSSSSSSSSSSSSSSCCCCCCCCCCCCCMMMHPPP
PPPHMMMCCSCCCCCCCSSSSSSSSSHHHHHHSSSSSSCCCCCCSSSSSCCSSSSSSCCSSSSSSSSSSHHHHHHSSSSSCCCCCCCSSSSCCMMMHPPP
PPPHMMCCCSSSSSCCCCCSSSSSSHHHHHHHHSSSSSCCCCCCCSSSSCCSSSSSSCCSSSSSSSSSHHHHHHHHCCCCCCCCCCCSSSSCCMMMHPPP
PPPHMMCCSSSSSSSSSSCCCCSSHHHHAAHHHHSSSSSCCCCCCSSSSCCSSSSSCCSSSSSSSSSHHHHHHHHDCCCCCSSSSSSSSSSCCMMMHPPP
PPPHMMCCSSSSSSSSSSSCCCCCCCHCAACHHHSSSSSSCCCCCCSSSCCSSSSSCSSSSSSSSSSHHCCCCCCCCCCSSSSSSSSSSSSCCMMMHPPP
PPPHMMCCSSSSSSSSSSSSSSCCCCCCBBCCHHSSSSSSSCCCCCCCSCCSSSSCSSSSSSSCCCCCCCCBBCCCHSSSSSSSSSSSSSSCCMMMHPPP
PPPHMMCCSSSSSSSSSSSSSSSSHHCCBBCCCCCCSSSSSSCCCCCCCCCCCCCCCSSSSSCCCCCCCCCBBCHHHSSSSSSSSSSSSSSCCMMMHPPP
PPPHMMCCSSSSSSSSSSSSSSSSHHHCCCCHCCCCSSSSSSSCCCCCCCCCCCCCCSSSSCCSSSSHHHCCCCHHHSSSSSSSSSSSSSSCCMMMHPPP
PPPHMMCCSSSSSSSSSSSSSSSSHHHHHHHHHHCCCCCSSSSCCMMMMCCMMMMCCSSCCCSSSSSHHHHAAHHHHSSSSSSSSSSSSSSCCMMMHPPP
PPPHMMCCSSSSSSSSSSSSSSSSSHHHHHHHHSUUCCCCCCCCCMXSSCCSSXMCCCCCSSSSSSSSHHHAAHHHSSSSSSSSSSSSSSSCCMMMMPPP
PPPHMMCCSSSSSSSSSSSSSSSSSSHHHHHHSSUUSSSSCCCCCMSSSCCSSSMCCCSSSSSSSSSSSHHHHHHSSSSSSSSSSSSSBBSCCMMMMPPP
PPPMMMCCSSSSSSSSSSSSSSSSSSSSSSSSSSSSSSSSSCCCCMSSSCCSSSMCCSSSSSSSSSSSSSSSSSSSSSSSSSSSSSSSBBSCCMMMMPPP
PPPMMMCCSSSSSSSSSSSSSSSSSSSSSSSSSSSSSHBHSSSCCMSSSCCSSSMCCSSSSSSSSSSSSSSSSSSSSSSSSSSSSSSDHHSCCCMMMPPP
PPPMMMCCSSSSSSSSSSSSSSSSSSSSSSSSSSSSSBHBSSSCCMSSUCCUSSMCCCCSSSSSSSSSSSSSSSSSSSSSSSSSSSSSBBSCCMMMBPPP
PPPMMMCCSSSSSSSSSSSSSSSSSSSSSSSSSSSSSSSSCCCCCMSSSCCSSSMCCCCCCSSSSSSSSSSSSSSSSSSSSSSSSSSSBBSCCMMMBPPP
PPPMMMCCSSSSSSSSSSSAAAASSSSSSSSSSSSSCCCCCCCCCMSSSCCSSSMCCCCCCCCSSSSSSSSSSSSSSSSSSSSSSSSSHHSCCMMMBPPP
PPPHMMCCSSSSSSSSSSSAAAADDSSSHHHSSCCCCCCCCCCCCMXSSCCSSXMCCSSCCCCCSSSSSSSSSSSSSSSSSSSSSSSSSSSCCMMMBPPP
PPPHMMCCSSSSSSSSSSSAAAABBSSSHHHSSCCCCCCCSSSCCMMMMCCMMMMCCSSSSCCCCCCCSSSSHHHHSSSSSSSSSSSSSSSCCMMMBPPP
PPPHMMCCSSSSSSSSSSSAAAABBSSSCCCCCCCCCHHSSSSSCCCCCCCCCCCCCSSSSSCCCCCCCCCCHHHHSSSSSSSSSSSSSSSCCMMMBPPP
PPPHMMCCSSSSSSSSSSSSSSSSSCCCCCCCCSHHHHHSSSSCCCCCCCCCCCCCCCSSSSSSSSCCCCCCCCCCSSSSSSSSSSSSSSSCCMMMBPPP
PPPHMMCCSSSSSSSSSSSSSCCCCCCCCCSSSSHHHSSSSSSCCSSSSCCSSSSCCCSSSSSSSSSCCCCCCCCCCCCCSSSSSSSSSSSCCMMBBPPP
PPPHHMCCSSSSSSSSSCCCCCCCCCCSSSSSSSSSSSSSSSCCCSSSSCCSSSSSCCSSSSSSSSSSSSSSCCCCCCCCCCSSSSSSSSCCCMMBBPPP
PPPHHMMCCSSSSSCCCCCCCCCCSSSSSSSSSSSSSSSSSSCCSSSSSCCSSSSSCCCSSSSSSSSSSSSSSSSSSCCCCCCCCSSSSSCCMMMBBPPP
PPPHHMMCCSSSSCCCCCCCCSSSSSSSSSSSSSSSSSSSSCCSSSSSSCCSSSSSSCCCSSSSSSSSSSSSSSSSSSSSCCCCCCCCCCCCMMMBBPPP
PPPHHMMCCSCCCCCCCSSSSSSSSSSSSSSSSSSSSSSSSCCSSSSSSCCSSSSSSCCCSSSSSSSSSSSSSSSSSSSSSSSCCCCCCCCCMMMBBPPP
PPPHHMMMCCCCCCSSSSSSSSSSSSSSSSSSSSHHHHHHCCSSSSSSSCCSSSSSSSCCHHHHHHSSSSSSSSSSSSSSSSSSSSCCCCCMMMBBBPPP
PPPHHMMMCCCSSSSSSSSSSSSSSSSSSSSSSHHHHHHCCCSSSSSSSCCSSSSSSSCCCHHHHHHSSSSHSSSSSHHHHHHSSSSSSCCMMMBBBPPP
PPPHHHMMCCSSSSSSSSSSSSSSSSSSSSSSHHHHHHCCHHSSSSSSSCCSSSSSSSHCCCHHHHHHSSSSSSSSSHBBHHHSSSSSSCCMMBBBBPPP
PPPHHHMMCCSSSSSSSSSSSSSSSSSSSSSSHHHCCCCHHHSSSSSSSCCSSSSSSSHHCCCCCHHHSSSSSSSSDHHHHBBSSSSSSCCMMBBBBPPP
PPPHHMMMCCSSSSSSSSSSSSSSSSSSSSSSHHHCBBCHHHSSSSSSSCCSSSSSSSHHHCBBCHHHSSSSSSSSSHHHHHHSSSSSCCMMMBBBBPPP
PPPHHMMMCCCSSSSSSSSSSSSSSSSSSSSSHHHCBBCHHHSSSSSHHCCSSSSSSSHHHCBBCHHHSSSSSSSSSBBHHHHSSSSSCCMMMBBBBPPP
PPPHHHMMMCCCSSSSSSSSSSSAAADSSSSSHHHCCCCHHHSSSSSHHCCSSSSSSSHHHCCCCCHHSSSSSSSSSSSSSSSSSSSCCMMMBBBBBPPP
PPPHHHMMMMCCSSSSSSSSSSSAAASSSSSSHHCCHHHHHHSSSSSHHCCSSSSSSSHHHHHHCCHHSSSSSSSSSSSSSSSSSSSCCMMMBBBBBPPP
PPPHHHHMMMCCCSSSSSSSSSSAAASSSSSSDCCHHHHHHSSSSSSHHCCSSSSSSSSHHHHHHCDSSSSSSSSSSSSSSSSSSSCCMMMBBBBBBPPP
PPPHHHHHMMMCCCSSSSSSSSSAAASSSSSSCCCHHHHHSSSSSSSHHCCSSSSSSSSSHHHHHCCSSSSSSSSSSSSSSSSSSCCCMMBBBBBBAPPP
PPPHHHHHHMMMCCSSSSSSSSSAAASSSSSSCCSSSSSSSSSSSSSHHCCSSSSSSSSSSSSSSCCCSSSSSSSSSSSSSSSSCCCMMMBBBBBAAPPP
PPPHHHHHHHMMCCCCSSSSSSSSSSSSSSSSCCSSSSSSSSSSSSSSSCCSSSSSSSSSSSSSSSCCCSAAAAASSSSSSSSSCCCMMBBBBBAAAPPP
PPPHHHHHHHMMMCCCSSSSSSSSSSSSSSSCCSSSSSSSSSSSSSSSSCCSSSSSSSSSSSSSSSCCCCAAAAASSSSSSSSCCMMMMBBBBAAABPPP
PPPHHHHHHHMMMMCCCSSSSSSSSSSSSSCCSSSSSSSSSSSSSSSSSCCSSSSSAAAASSSSSSSCCCSSDAASSSSSSSCCCMMMBBBBAAAABPPP
PPPHHHHHHHHMMMMCCCSSSSSSSSSSSCCCSSSSSSSSSSSSSSSSSCCHHSSSAAAADSSSSSSSCCCSSAASSSSSSCCCMMMABBBBAABBBPPP
PPPHHHHHHHHHMMMCCCCSSSSSSSSSSCCSSSSSSSSSSSSSSSSSSCCHHSSSSSSSSSSSSSSSCCCCSAASSSSCCCCCMMAAABBBAABBBPPP
PPPHHHHHHHHHHMMMCCCCSSSSSSSSCCSSSSSSSSSSSSSSSAASSCCHHSSSSSSSSSSSSSSSSCCCSAASSSSCCCMMMMBAAABAABBBBPPP
PPPHHHHHHHHHHMMMMMCCCCSSSSSCCCSSSSSSSSSSSSSSSAASSCCHHSSSSSSSSSSSSSSSSCCCCSSSSSCCCMMMMBBAAAAAABBBBPPP
PPPHHHHHHHHHHHMMMMMCCCCSSSCCCSSSSSSSSSSSSSSSSAASSCCSSSSSSSSSSSSSSSSSSSCCCCSSSCCMMMMMBBBBAAAABBBBBPPP
PPPHHHHHHHHHHHHHMMMCCCCCSSCCSSSSSSSSSSSSSSSSSAADSCCSSSSSSSSSSSSSSSSSSSSCCCCSCCCMMMMHBBBBBAAABBBBBPPP
PPPHHHHHHHHHHHHHHMMMMCCCCCCSSSSSSSSSSSSSSSSSSSSSSCCSSSSSSSSSSSSSSSSSSSSSCCCCCCMMMMHBBBBBBBAAABBBBPPP
PPPHHHHHHHHHHHHHHHMMMMCCCCCSSSSSSSSSSSSSSSSSSSSSSCCSSSSSSSSSSSSSSSSSSSSSSCCCCMMMMHHBBBBBBBBAAABBBPPP
PPPHHHHHHHHHHHHHHHHMMMMDCCCCSSSSSSSSSSSSSSSSSSSSSCCSSSSSSSSSSSSSSSSSSSSSCCCCDMMMHHHBBBBBBBBBAABBBPPP
PPPHHHHHHHHHHHHHHHHHMMDDCCCCCSSSSSSSSSSSSSSSSSSSSCCSSSSSSSSSSSSSSSSSSCCCCCCDDCMHHHBBBBBBBBBBAAAABPPP
PPPHHHHHHHHHHHHHHHHHMMCCDMCCCCCSSSSSSSSSSSSSSSSSSCCSSSSSSSSSSSSSSSCCCCCCMMMMCHHHBBBBBBBBBBBBBAAAAPPP
PPPHHHHHHHHHHHHHHHHHHHHCMMMCCCCCCCSSSSSSSSSSSSSSSCCSSSSSSSSSSSSSCCCCCCCMMMMMHHHHBHHBBBBBBBBBBBBAAPPP
PPPHHHHHHHHHHHHHHHHHHHHHMMMMMCCCCCCCCSSSSSSSSSUUSCCSSSSSSSSSSSCCCCCMMMMMMMHHHHHHHHHBBBBBBBBBBBBAAPPP
PPPHHHHHHHHHHHHHHHHHHHHHMMMMMMMCCCCCCCSSSSSSSSUUSCCSSSSSSSCCCCCCCCMMMMMMHHHHHBBHHBBBBBBBBBBBBBBBBPPP
PPPHHHHHHHHHHHHHHHHHHHHHHHHMMMMMMMMCCCCCCCCCCCCCCCCCCCCCCCCCCCCMMMMMMMMHHHHHHHHHHBHHBBBBBBBBBBBBBPPP
PPPHHHHHHHHHHHHHHHHHHHHHHHHHHMMMMMMMCCCCCCCCCCCCCCCCCCCCCCCCMMMMMMMMMHHHHHHHHHHHBBHHBBBBBBBBBBBBBPPP
PPPHHHHHHHHHHHHHHHHHHHHHHHHHHHHHMMMMMMMMMMMMCMMMMCCMMMMMMMMMMMMMMMHHHHHHHHHHHHBBHHHHBHHBBBBBBBBBBPPP
PPPHHHHHHHHHHHHHHHHHHHHHHHHHHHHHHHHMMMMMMMMMMMMMMMMMMMMMMMMMMMMHHHHHHHHHHHHHHHHHHHBBBHHBBBBBBBBBBPPP
PPPHHHHHHHHHHHHHHHHHHHHHHHHHHHHHHHHMMMMMMMMMMMMMMMMMMMMMMMMMHHHHHHHHHHHHHHHHHHHHHBHHHHBBHBBBBBBBBPPP
PPPHHHHHHHHHHHHHHHHHHHHHHHHHHHHHHHHHHHHHHHHHHMMMHMMHHHHHHHHHHHHHHHHHHHHHHHHHHHHHHHHHHBBHHHHHHBBBBPPP
PPPPPPPPPPPPPPPPPPPPPPPPPPPPPPPPPPPPPPPPPPPPPPPPPPPPPPPPPPPPPPPPPPPPPPPPPPPPPPPPPPPPPPPPPPPPPPPPPPPP
PPPPPPPPPPPPPPPPPPPPPPPPPPPPPPPPPPPPPPPPPPPPPPPPPPPPPPPPPPPPPPPPPPPPPPPPPPPPPPPPPPPPPPPPPPPPPPPPPPPP
PPPPPPPPPPPPPPPPPPPPPPPPPPPPPPPPPPPPPPPPPPPPPPPPPPPPPPPPPPPPPPPPPPPPPPPPPPPPPPPPPPPPPPPPPPPPPPPPPPPP
1111111111111111111111111111111111111111111111111111111111111111111111111111111111111111111111111111
1111111111111111111111111111111111111111111111111111111111111111111111111111111111111111111111111111
1111111111111111111111111111111111111111111111111111111111111111111111111111111111111111111111111111
1111111111111111111111111111111111111111111555555115555511111111111111111111111111111111111111111111
1111111111111111111111111111111111111111155555555115555551111111111111111111111111111111111111111111
1111111111111111111111111111111111555555555555555115555555555555111111111111111111111111111111111111
1111111111111111111111111111111111555555555111111111111555555555511111111111111111111111111111111111
1111111111111111111111111111111155555555551111111111111155555555555111111111111111111111111111111111
1111111111111111111111111111115555111111111111155115151111111111555555511111111111111111111111111111
1111111111111111111111111111155555111115155515555115151111111111155555551111111111111111111111111111
1111111111111111111111111115555511151515151115115115151125151121111115555511111111111111111111111111
1111111111111111111111115555555115551515151555115115551535151535111111555551111111111111111111111111
1111111111111111111111155555511115111515151111155115111545151545111111155555111111111111111111111111
1111111111111111111111555551111515155515555555555115551555151555155551111555511111111111111111111111
1111111111111111111155555511111515154511111115345115151511151111151115111155555111111111111111111111
1111111111111111111555551115551515153555555515235115151515551111151515111115555511111111111111111111
1111111111111111115555511115111515112511151315115115111515111111151515151111555551111111111111111111
1111111111111111155555111115551515551111151515155115555515551111151515155111155555111111111111111111
1111111111111111555511111111151523451111151515111111131531111111151511151111111555511111111111111111
1111111111111111555511155111155515551111151555511111151515551111151551551111111155551111111111111111
1111111111111115555111155511115523141111111111115111151511151111152511511111111115555111111111111111
1111111111111155551115555511111535151111155555555111151555151555553515111551111111555511111111111111
1111111111111555511115111511111545141111432511115111151115151111154555115515111111155551111111111111
1111111111115555111115151511111155151111151515555115455515155555155511155515511511115551111111111111
1111111111155551111115151511111155111111151515111115154515111115115511151511111511111555111111111111
1111111111155511111115151511111115551515551515111111113515555515555111551555551555511155511111111111
1111111111155511111111151551111111551415111511111111112511151515151115151111151411111115511111111111
1111111115555111555555551555111111151515155511111111111155151515111115151555155555151115551111111111
1111111115551115111511152345511111155515111511111111111111151115551155151511151115251115555111111111
1111111115551115151515151555511111111515151511111111111155555511511555151515155515355115555511111111
1111111155511111151525111511111111111511151511111111111111131111111515151515111115411511155511111111
1111111155111555551535555515511111111555551421111111111115551111111115155515555515551511115511111111
1111111555111543251345111115151511111151111431111111111115141111151115111115111515151111115555111111
1111115511111555155555555515151551111155155511111111111113155111155535555555551515155555115555111111
1111115511151111111111151115111511111111155111111111111115111111551115111111151511151155111511111111
1111115511555511111555151555551511111111115555111111111545151155551515551555151555151555111111111111
1111111111555511111111451111451411511111115511151111111115511143111511111515111411111511111111111111
1111111111111555555555153555155555141111115515155115555555511555211555555515554511115511111115551111
1111151111111111551511151115111511155111111555115115111111111543153411111511111511111111111115551111
1111555111111111155515155511111115411511111155155115551551155555552511111115555511111115555115551111
1111551115555511111555551111111115151511111115115115152551111515113511111111111111111115111115551111
1111551115155555551111551111111111115551111115555115153511555515151111111111111115555555155115551111
1111551111153115155111111111111111511155111111555115114515151111551111111111111551111115141115551111
1111551155551515155555111111111111555115511111115115115155151551111111111111155555515555155115551111
1111551111151511111115111111111111115522351111111111111111151511111111111111234511111111151115551111
1111551115151555555515511111111111115555345111111111111115155115555111111111155515555555551115551111
1111551115111511151115111111111111111115555112222222222115511155511111111111111511151115141115551111
1111551155555555151555551111111115111111111112333333332111115555551511111111551555151555155115555111
1111551115111111151543211111111115115555111112344444432111551111151511111115151115151514111115555111
1115551115151555151555155555111515155555511112345555432111151555151555155535155515151515111115555111
1115551115151511151111152115111145111234551112345665432111152345151115151115111513151514111111555111
1115551155151555555555553515151515511234551112345665432111155555155551151555151555551555111115551111
1115551111151111111111354515154135115555111112345555432111111555151111151545151115111114111115551111
1115551115555555555111155515151155551111111112344444432111111115151515551535151515555515111115551111
1111551115111123451111111115111151111111111112333333332111111111155535432521151511111514111115551111
1111551155155515551111111555111111111111555112222222222111111111111115551111552515551515555115551111
1111551115234515111111111555111111111115234511111111111111111511111111111111543515111511151115551111
1111551115155515155555555111111111111145155111111111111111111555551111111111552515155515551115551111
1111551111151115555551111111115551111511155111115115111111155511155111111111111155551115111115511111
1111151115511555511111111115551551155515151115115115511111154325151355551111111111555555151115511111
1111155115115511111111115551111515151115151155515115555511155515111111155555511111111555551155511111
1111155111515111111115551515155515151515111555555115111151115555511511151151555511111111111155511111
1111155111111111155155111515111511315551111521115115111151111111515555111141111555511111111155511111
1111155511111155555111551515551515111111115535155115515515111111111155551555155555555511111555111111
1111155511155555111111111511151141111111115545155115111511111111111151111115111111151555511555111111
1111115511555515151555555555151511111111115555155115155555111111111155155515511111151545111551111111
1111115511154515151115111111154111111111111511155115111115111111111115111515111111151535111551111111
1111155511153515555515155555551511111111113111111111111234111111111115555515511111151521115551111111
1111155511152115112115111135111511111111111521111115151115111111111115111521111111111511115551111111
1111115551111555155555111115551511111111111535111115151555111111111155551535155535555511155511111111
1111115555111515411111111111451511111111111545111115151115111111111111111545111515111111155511111111
1111111555111515155555511155151511111111111555111115555555511111111515555555151515551111555111111111
1111111155511111151111111111151111111111114111111115151111151111111511111115151511111111551111111111
1111111115551155551555111115555511551115555555511115151515555555511155555545551555511115551111111111
1111111111551111111511151511111511511531111111115115151515111111551115111111111511111115511111111111
1111111111555111555515551551155115155555555555555115151515155555551111111115552511111555511111111111
1111111111555511141115114521551155111115111115115115151511111111155111551115343511111555111111111111
1111111111155551115555151535511155515515555515155111155511111555555511155115255511115551111111111111
1111111111115551111511151545511551111511111115115111151111151511111511115115151111115511111111111111
1111111111111555111155151555115515155555555511155111151555155515555551115115151111555511111111111111
1111111111111555551111151551115115153111111511155111151515111115111551111555111115555111111111111111
1111111111111155555111151511155515551555551511155115151515555555151555111155111555551111111111111111
1111111111111111555111115511554511111111151511115115111111111511151515511111111555511111111111111111
1111111111111111155551111115553515555555551515155115555555551515551515551111115555111111111111111111
1111111111111111115555111115112515111512341515115115111115151513451115151111155551111111111111111111
1111111111111111111555511111155515551515551515555115555515151555355515111111155511111111111111111111
1111111111111111111155111111151115111511151511155115432515131511251511111111115111111111111111111111
1111111111111111111155111511111555155555151555155115551515155515551111115555111111111111111111111111
1111111111111111111111115551111111151111151515115115111515111115111111155555111111111111111111111111
1111111111111111111111115555511111111555551515115115155515555111111555555511111111111111111111111111
1111111111111111111111115555555111111111151111115115111511111111115555551111111111111111111111111111
1111111111111111111111111115555555511111111111111111111111111115555555511111111111111111111111111111
1111111111111111111111111111155555551111111111111111111111115555555551111111111111111111111111111111
1111111111111111111111111111111155555555555515555115555555555555551111111111111111111111111111111111
1111111111111111111111111111111111155555555555555555555555555551111111111111111111111111111111111111
1111111111111111111111111111111111155555555555555555555555551111111111111111111111111111111111111111
1111111111111111111111111111111111111111111115551551111111111111111111111111111111111111111111111111
1111111111111111111111111111111111111111111111111111111111111111111111111111111111111111111111111111
1111111111111111111111111111111111111111111111111111111111111111111111111111111111111111111111111111
1111111111111111111111111111111111111111111111111111111111111111111111111111111111111111111111111111
