40
40
PPPPPPPPPPPPPPPPPPPPPPPPPPPPPPPPPPPPPPPP
PPPPPPPPPPPPPPPPPPPPPPPPPPPPPPPPPPPPPPPP
PPPPPPPPPPPPPPPPPPPPPPPPPPPPPPPPPPPPPPPP
PPPHHHHHSSSSSSSSSHHHHHHHHHHHHHSSSSSSSPPP
PPPHHHHHSSSSSSSSSHHHHHHHHHHHHHSSSSSSSPPP
PPPHHHHHSSSSSSSSSSHHHHHUHHHHHHSSSSSSSPPP
PPPHHHSSSSSSSSSSSSHHHHHHHHHHHHSSSSSSSPPP
PPPHHHSSSSSSSUSSSSHHHHHHHHHHHHSSSSSSSPPP
PPPHHHSSSSSSSSSSSSHHHHHHHHHHHHHSSSSSSPPP
PPPHHHSSSSSSSSAAASHHHHHHHHHHUHHHSSSSSPPP
PPPHHHSSSSSSSSAAAAHHHHHHHHHHHHHHHHHHHPPP
PPPHHHHHHHBSSSAAAAAHHHHHHHHHHHHHHHHHHPPP
PPPHHHHHHHBBBBBAAAAAHHHHHHHHHHHHHHHHHPPP
PPPHHHHHHHBBBBBHAAAAAHHHHHHHHHHHHHHHHPPP
PPPHHUHHHHBBBBBHHAAAAAHHHHHHHHHHHHHHHPPP
PPPHHHHUHHHHHHHCHHAAAAAHHHHHHHHHHHHHHPPP
PPPHHHHHHHHHHHHHSHHAAAAAHHHHHHHHHHHHHPPP
PPPHHUHHHHBBBBBXHCHHAAAAAHHHHHHHHHHHHPPP
PPPHHHHHHHBBBBBHHHSDBAAAAAHHHHHHHHHHHPPP
PPPHHHHHHHBBBBBHHHHBBBAAAAAHHHHHHHHHHPPP
PPPHHHHHHHBBBBBHHHHBXBHAAAAAHHHHHHHHHPPP
PPPHHHHHHHBBBUBHHHHHHCHHAAAAAHHHHHHHHPPP
PPPHHHHHHHHHHHHHHHHHHHSHHAAAAAHHHHHHHPPP
PPPHHHHHHHHHHHHHHHHHHHHCHHAAAAAHHHHHHPPP
PPPHHHHHHHHHHHHHHHHHHHHHSHHAAAAAHHHHHPPP
PPPHHHHHHHHHHDHHHHHHHHHHHCHHAAAAHHHHHPPP
PPPHHHHHHHHHHHHHHHHHHHHHHHSHAAAAAHHHHPPP
PPPHHHHHHHHHHHHHHHHHHHHHHHHAAAAAAAHHHPPP
PPPHHHHHHHHHHHHHHHHHHHHHHHAAAAAAAAAHHPPP
PPPHHHHUHHHHHHHHHHHHHHHHHHAAAAAAAAAHHPPP
PPPHHHHHHHHHDHHHHHHHHHHHHHAAAAAAAAAHHPPP
PPPHHHHHDHHHHHHHHHHHHHHHHHAAAAAAAAAHHPPP
PPPHHHHHHHHHHHHHHHHHHHHHHHAAAAAAAAAHHPPP
PPPHHHHHHHHHHHHHHDHHHHHHHHHAAAAAAAHHHPPP
PPPHHHHHHHHHHHHHHHHHHHHHHHHHAAAAAHHHHPPP
PPPHHHHHHHHHHHHHHHHHHHHHHHHHHHHHHHHHHPPP
PPPHHHHHHHHHHHHHHHHHHHHHHHHHHHHHHHHHHPPP
PPPPPPPPPPPPPPPPPPPPPPPPPPPPPPPPPPPPPPPP
PPPPPPPPPPPPPPPPPPPPPPPPPPPPPPPPPPPPPPPP
PPPPPPPPPPPPPPPPPPPPPPPPPPPPPPPPPPPPPPPP
0000000000000000000000000000000000000000
0000000000000000000000000000000000000000
0000000000000000000000000000000000000000
0003335588887777856333333333657879999000
0003336689999988856633333334567779987000
0003366593958989796533323333659777797000
0003667848486989885533333333658788999000
0003657789886689896633333333557777789000
0003568788999879785633333333656798899000
0003469998989811195533333333465589798000
0003558979777811116533333333334666565000
0003365566298711111333333333333566556000
0003335656424421111133333333333333333000
0003333333223245111113333333333333333000
0003393333443243311111333333333333333000
0003333233333331331111133333333333333000
0003333333333333133111113333333333333000
0003393333432441313311111333333333333000
0003333333332323331341111133333333333000
0003333333222343333424111113333333333000
0003333333424223333412311111333333333000
0003333333334423333331331111133333333000
0003333333333333333333133111113333333000
0003333333333333333333313311111333333000
0003333333333333333333331331111122333000
0003333333333433333333333122111122233000
0003333333333333333333333212111112223000
0003333333333333333333332221111111222000
0003333333333333333333332211111111122000
0003333433333333333333332211111111122000
0003333333334333333333332211111111122000
0003333313333333333333332211111111122000
0003333333333333333333332211111111122000
0003333333333333323333332221111111222000
0003333333333333333333333222111112223000
0003333333333333333333333322222222233000
0003333333333333333333333332222222333000
0000000000000000000000000000000000000000
0000000000000000000000000000000000000000
0000000000000000000000000000000000000000
