50
50
PPPPPPPPPPPPPPPPPPPPPPPPPPPPPPPPPPPPPPPPPPPPPPPPPP
PPPPPPPPPPPPPPPPPPPPPPPPPPPPPPPPPPPPPPPPPPPPPPPPPP
PPPPPPPPPPPPPPPPPPPPPPPPPPPPPPPPPPPPPPPPPPPPPPPPPP
PPPHHHHHBBHHHHHHHSSHHHHHBHHHHHHSSHHHHSSHHHHSSHHPPP
PPPHHHHHHHHHSHHHSHSSSHHHHHHHHHSSHHHHSSHHHHHSSHHPPP
PPPSHSHHHHSSSSSSSSSSSSSHHHHHSHHSHASAASSAAASSHSHPPP
PPPSSSSHSSSSSSSSHSSSHSSSHSHSSSSSSSSSSSSSSASSSSSPPP
PPPHSSSSSSHHSSSHHHSSHSSSSSSSSSSHSSASSSSSSSSHSHSPPP
PPPHSSSSSHSSSSSSHSSHSSSSSHSHSHHSSAAAASSAASSHHHSPPP
PPPSSSSSSSSSSSSSSHSSSHHSHHHHHHSSHAAAASSAAASSHHSPPP
PPPSPSPSPSPSPSPPSSDHHHHHHHHHHHSSHAAAASSAAASSHHSPPP
PPPSSSSSSSSSSSSSSSSHHHHHHHHHHSSHHAASSSAAASSHHHSPPP
PPPSPSPSPSPSPSPSPSSSHHHHHHHHHSSHHSCCCCAASSAASSSPPP
PPPSSSSSSSSSSSSSSSSSSSSSHSSSSHCCCCCAACCSSAAASSSPPP
PPPSPSPSPSPSPPSPPSSHSSSSCCCCCCCHSAAAAACSSSAAAHSPPP
PPPSSSSSSSSSSSSSSSSSHHHHUHHHSSHHHHHHHHCSHSSHHHSPPP
PPPSPSPSPSPSPPSPPSHSSHHHHHHSSHHHBBHHHSCHHSSHHHSPPP
PPPSSSSSSSSSSSSSSSSSHHHHHHSSHHHHHHHHHHCSHHSSHHSPPP
PPPSPSPSPSPSPSPPPSHSSHHHHSSHDHHHHHHHHHCSHSSHHHSPPP
PPPSSSSSSSSSSSSSSSDHSSHHHHSSHBBHHHHHDSCHHHSSHHHPPP
PPPSPSPSPSPSPSPSPSHHHSSHHSSHHHHHBHHHHSCHHHSSHHHPPP
PPPSSSSSSSSSSSSSSSHHHSSHHHSSHHHHBHHHHHCSHSSHHHDPPP
PPPPPSSSSSXSSSSPPSHHHDSSHHHSSHHHHHHHHSCHSSAAHHHPPP
PPPSSSPPPPPPPPSSSSHHHHSSHHSSHHHHHBBHHSCHHSSAAHHPPP
PPPSSSSSSSSSSSSSSSHHHHHSBBSHHHHHHHHHHSCHHHSSHHHPPP
PPPSPSPDSPPSSPPSPSHHHHSSSSHHHHHHHHHHHCCHHSSHHHHPPP
PPPSSSSSSSSSSSSSSSHHDSSHHSSHHHHBBHHHSCHHSSASSSSPPP
PPPSPSPSPSPSPSPSPSHHHHSHHSHHHHHHHHHHHCCSSHHAASSPPP
PPPAAAAAAAAAAAAASSSSSSSSHHHSHHHHHHHHHHCSHHHAAHHPPP
PPPAAAAAAAAAAAAAPSPSPSPSHSSHHBBBHHHHHSCSSHAAHHHPPP
PPPAAAAAAAAAAAAASSSSSSSSSSHHHHHBHHBHHHCCHHAAHHHPPP
PPPAAAAAAAAAAAAASPSPSPSPSSSHHHHBHHHHHHSCHHAAHHHPPP
PPPAAAAAAAAAAAAASSSSSSSSSSHHHHHHHHHHHHHCHAAHHHHPPP
PPPAAAAAAAAAAAAAPSPSPSPSHSSHHHHBHHHHHHSCHAAHHHHPPP
PPPAAAAAAAAAAAAASSSSSSSSHSSHHHHHBHHHHHCCHAAHHHHPPP
PPPAAAAAAAAAAAAAPSPSPSPSSSHHHHHBHHHHHSCHAAHHSSHPPP
PPPAAAAAAAAAAAAASSSSSSSSHSSHHBHHHHHHHSCAASSCCCUPPP
PPPAAAAAAHAAAAAASPSPSPSPSSSHSHHHBHHHSSCCCCCCHHHPPP
PPPAABAACCCCAAAASSSSSSSSCCCCCCCHSHHSSHCSSAAHHHHPPP
PPPUCCCCCAACCAAAPPPPPPPPCSASABCCCCSSHSCSHAAAHHHPPP
PPPHHAHHAAAACCAACCCCCCCCCAAHAHSSHCCCCCCSAAHAAHHPPP
PPPAAAAAAAAAACCCCSAHHDSSHAHHHHHHHHHHSHHSSHHHAAAPPP
PPPHDHHHHAHAAHSSHHAHHHHSSHHHHBBBHHHHSSSSHHHHHAAPPP
PPPHHHHAAAAAAHHHHHHXHHHSSHHHHBBBHHHHHSSAAHHHHHHPPP
PPPHAHHHAHAHHHHHHHHHHHHHSSHHHBBBHHHHHSSAAHHHHHHPPP
PPPAAAAHHBBBBBBBBBBBBBBBHSSHHHHHHHHHSSSSHHHHHHHPPP
PPPAHAHHHHHHHHHHHHHHHHHHSSSSDHHHHHHSSHHSSHHHHHHPPP
PPPPPPPPPPPPPPPPPPPPPPPPPPPPPPPPPPPPPPPPPPPPPPPPPP
PPPPPPPPPPPPPPPPPPPPPPPPPPPPPPPPPPPPPPPPPPPPPPPPPP
PPPPPPPPPPPPPPPPPPPPPPPPPPPPPPPPPPPPPPPPPPPPPPPPPP
00000000000000000000000000000000000000000000000000
00000000000000000000000000000000000000000000000000
00000000000000000000000000000000000000000000000000
00011133333333333223333311111112211112211112211000
00011133333323332322233311111122111122111112211000
00021233332222222222222311112112112112211122121000
00022223222222223222322212122222222222222122222000
00012222223322233322322222222221221222222221212000
00012222232222223223222221212112211112211223332000
00022122222222222322233211111122111112211122332000
00021132222222222243333311111122111112211122332000
00011132222222222223333311111221111222111223332000
00011132223332222222333311111221122222112211222000
00011132222222223222222212222122222112222111222000
00011122222222223223222222222221211111222211132000
00011122222222222222333321112211111111223223332000
00011222222222222232233311122111111112213223332000
00012222222222222222333311221111111111223322332000
00011122222222222232233312211111111111223223332000
00011122222222222243223311221111111112213322333000
00011111111111111111122112211111111112213322333000
00011111111111111111122111221111111111223223331000
00011111111111111111142211122111111112212211333000
00011111111111111111112211221111111112213221133000
00011111111111111111111222211111111112213322333000
00011111111111111111112222111111111112213223333000
00011111111111111111422112211111111122112211222000
00011111111111111111122112211111111112222111122000
00011111111111111111122111221111111333223331133000
00011111111111111111112212211111111332222311333000
00011111111111111111111122111111111333223311333000
00011111111111111111111222211111111333223311333000
00011111111111111111111122111111111333322113333000
00011111111111111111111112211111111333223113333000
00011111111111111111111112211111111333223113333000
00011111111111111111111122111111111332231133223000
00011111111111111111111112211111111332211222222000
00011111121111111111111122212111111322322222332000
00011211222211111111111222222211211223222113333000
00022222212221111122221122121222222232233111333000
00022122111122112222222221131322322222221131133000
00011111111112222213312231333333333323322333111000
00011111111111221113333223333333333322221111111000
00011111111111111113333223333333333332211111111000
00011111111111111113333322333333333332211333333000
00011111111111111113333332233333333322223333333000
00011111111111111113333322221333333223322333333000
00000000000000000000000000000000000000000000000000
00000000000000000000000000000000000000000000000000
00000000000000000000000000000000000000000000000000
