75
75
PPPPPPPPPPPPPPPPPPPPPPPPPPPPPPPPPPPPPPPPPPPPPPPPPPPPPPPPPPPPPPPPPPPPPPPPPPP
PPPPPPPPPPPPPPPPPPPPPPPPPPPPPPPPPPPPPPPPPPPPPPPPPPPPPPPPPPPPPPPPPPPPPPPPPPP
PPPPPPPPPPPPPPPPPPPPPPPPPPPPPPPPPPPPPPPPPPPPPPPPPPPPPPPPPPPPPPPPPPPPPPPPPPP
PPPAAAAAACCCCCHHHHHHHHHHHHHHHHHHHHHHHHHAAAAAAAAAHHHHHHHHHHHHHHHHHHHHHHHHPPP
PPPAAAAAACCAACCHHHHHHHHHHHHHHHHHHHHHHHHHAAAAAAAHHHHHHHHHHHAAHHHHHHHHHHHHPPP
PPPAAAAAAACCAACHAAAHHHHHHHHHAAAAAAHHHHHHAAAAAAAHHHHHHHHHAAAAAAHHHHHHHHHHPPP
PPPAAAAAAAACSSCCCUAAHHHHHHHAAAAAAAAHHHHHHAAAAAHHHHHHHHHHAAAAAAHHHHHHHHHHPPP
PPPAAAAAAHHCHHAAAAAAAHHHHHAAAAAAAAAAHHHHHHAUAHHHHHHHHHHAAAAAAAAHHHHHHHHHPPP
PPPAAAAHBBHCHHAAAAAAAHHHHAAAAAAAAAAAAAHHHHHSHHHHHHHHHHHAAAAAAAAHHHHHHHHHPPP
PPPAAHHHHBCCHHHAAAAAHHHHHAAAUAAAAAAAAAHHHHHSHHHHHHHHHHAAAAAAAAAAHAAAAHHHPPP
PPPHHHHHHCCBHHHHAAAHHHHHHHAACAAAAAAAHHHHHHHSHHHHHHHHHHAAAAAAAAAAAAAAAAHHPPP
PPPHHHHHCCHBHHHHHHHHHHHHHHHACAAAAAAHHHHHSSSSSSHHHHHHHHACCCCUAAAAAAAAAAAHPPP
PPPHHHHHCHHBHHHHHHHHHHHHHHHHCAAAAAHHHHHHSHHHHSHHHHHHHHHCAAAAAAAAAAAAAAAAPPP
PPPHHHHHCHHBHHHHHHHHHHHAHHHHCHHHHHHHHHHHSHHHHSHHHHHHHHHCAAAAAAAAAAUAAAAAPPP
PPPHHHHHCHBBHHHHHHHHHHAAAHHHCCCCCCHHHHHHSHHHHCCCHCHHHHHCAAAAAAHAAAAAAAAAPPP
PPPHHHHHCCBHHHHHHHHHHAAUAAHHCSSSSCCHHHHHSHHHHCDCHCHHHHHCAAAAAAHHAAAAAAAHPPP
PPPHHHHHBCCHHCCCCCCHHHACCHHHCHHHHCCCCCCCSHHHHCHCHCHHHHHCHHAAHHHHHAAAAAHHPPP
PPPHHHHHBHCCCCHHHHCHHHHACHHHCHHHHCCCCCCCCCCCCCHCHCCCCCCCHHHHHHHHHAAAAHHHPPP
PPPHHHHHBHHCHHHHHHCHHHHHCCCCCHHHHHHHHHHHHHHHHCHCDCHHHHHSHHHHHHHHHSHHHHHHPPP
PPPHHHHHBHHCHHHHHHCHCCHHCHHHHHHHHHHHHHHHHHHHHCHCCCHHHHHSHHHHHHHHHSHHHHHHPPP
PPPHHHHHBBHCHHHHHHCCCCCCCHHHHHHHHHHHHHHHHHHHHCHCCCHHHHHSHHHHHHHHHSHHHHHHPPP
PPPHHHHHHBCCSSSSSSCCHHHHHHHHHHHHHHHHHHHHHHHHHHHHHHHHHHHSHHHHHHHHHSHHHHHHPPP
PPPHHHHHHCCBHHHHHHCHHHHHHHHHHHHHHHHHHHHHHHHHHHHHHHHHHHHSHHHHHHHHHSHHHHHHPPP
PPPHHHHHCCHBHHHHHHCHHHHHHHHHHHHHHHHHHHHHHHHHHHHHHHHHHHHSSSSSSHHHHSHHHHHHPPP
PPPHHHHHCHHBHHHHHHCHHHHHHHHHHHHHHHHHHHHHHHHHHHHHHHHHHHHSSSSSSSSSSSSSXHHHPPP
PPPHHHHHCHHBHHHHHHCCHDHHHHHHHHHHHHHHHHHHHHHHHHHHHHHHHHHHHHHHHHHHHSHHHHHHPPP
PPPHHHHHCHBBHHHHHHHCCCHHHHHHHHHHHHHHHHHHHHHHHHHHHHHHHHHHHHHHHHHHHSHHHHHHPPP
PPPHHHHHCCBHHHHHHHHHHHHHHHHHHHHHHHHHHHHHHHHHHHHHHHHHHHHHHHHHHHHDHSHHHHHHPPP
PPPHHHHHBCCHHHHHHHHHHHHHHHHHHHHHHHHHHHHHHHHHHHHHHHHHHHHHHHHHHHHSHSHHHHHHPPP
PPPHHHHHBHCCHHHHHHHHHHHHHHHHHHHHHHHHHHHHHHHHHHHHHHHHHHHHHHHHHHHSHSHHHHHHPPP
PPPHHHHHBHHCHHHHHHHHHHHHHHHHHHHHHHHHHHHHHHHHHHHHHHHHHHHHHHHHHHHSSSHHHHHHPPP
PPPHHHHHBHHCHHHHHHHHHHHHHHHHHHHHHHHHHHHHHCCCCCCCCHHHHHHHHHHHHHHHHHHHHHHHPPP
PPPHHHHHBBHCHHHHHHHHHHHHHHHHHHHHHHHHHHHCCBBBBBBBBCCHHHHHHHHHHHHHHHHHHHHHPPP
PPPHHHHHHBCCHHHHHHHHHHHHHHHHHHHHHHHHHHCBBBBBBBBBBBBCHHHHHHHHHHHHHHHHHHHHPPP
PPPHHHHHHCCBHHHHHHHHHHHHHHHHHHHHHHHHCCCCCCCCMMMMBBBBCHHHHHHHHHHHHHHHHHHHPPP
PPPHHHHHCCHBHHHHHHHHHHHHHHHHHHHHHHCCBBBBBBBBCCCCMMBBBCHHHHHHHHHHHHHHHHHHPPP
PPPHHHHHCHHBHHHHHHHHHHHHHHHHHHHHHCBBBBBBBBBBBBBBCCMMBCHHHHHHHHHHHHHHHHHHPPP
PPPHHHHHCHHBHHHHHHHHHHHHHHHHHHHHCBBBBBBBBBBBBBBBBBCCMBCHHHHHHHHHHHHHHHHHPPP
PPPHHHHHCHBBHHHHHHHHHHHHHHHHHHHCBBBBBCCCCCBBBBBBBBBCCBCHHHHHHHHHHHHHHHHHPPP
PPPHHHHHCCBHHHHHHHHHHHHHHHHHHHHCBBBCCCCCCCCCCBBBBBBBBCCHHHHHHHHHHHHHHHHHPPP
PPPHHHHHBCCHHHHHHHHHHHHHHHHHHHHHCCCCCCCCCSCCCCCCBBBBBBCHHHHHHHHHHHHHHHHHPPP
PPPHHHHHBHCCHHHHHHHHHHHHHHHHHHHHHCCCCCCCSSCCCCCCCCBBBBBCHHHHHHHHHHHHHHHHPPP
PPPHHHHHBHHCHHHHHHHHHHHHHHHHHHHHCCCCCCCSSSCCCCCCCCCBBBBCHHHHHHHHHHHHHHHHPPP
PPPHHHHHBHHCHHHHHHHHHHHHHHHHHHHCCCCCCCSSSSSCCCCCCCCCBBBBCHHHHHHHHHHHHHHHPPP
PPPHHHHHBBHCHHHHHHHHHHHHHHHHHHHCHCCCCCSSSSSCCCCCCCCCBBBBCHHHHHHHHHHHHHHHPPP
PPPHHHHHHBCCHHHHHHHHHHHHHHHHHHHHHCCSCSSSSSCSCCCCCCCCCBBBCHHHHHHHHHHHHHHHPPP
PPPHHHHHHCCBHHHHHHHHHHHHHHHHHHHHHCCSPCSSSSPCSCCCCCCCBCBBCHHHHHHHHHHHHHHHPPP
PPPHHHHHCCHBHHHHHHHHHHHHHHHHHHHHHHCSACSSSSCASCSCCCCCBBBCHHHHHHHHHHHHHHHHPPP
PPPHHHHHCHHBHHHHHHHHHHHHHHHHHHHHHHCASSSSSSSSASSCSCCCBCCHHHHHHHHHHHHHHHHHPPP
PPPHHHHHCHHBHHHHHHHHHHHHHHHHHHHHHHCASSSSSSSSASSCSSCCCHHHHHHHHHHHHHHHHHHHPPP
PPPHHHHHCHBBHHHHHHHHHHHHHHHHHHHHHHCASSSPSSSSASSSSSCCHHHHHHHHHHHHHHHHHHHHPPP
PPPHHHHHCCBHHHHHHHHHHHHHHHHHHHHHHHHCSSSSSSSSSSSSSCHHHHHHHHHHHHHHHHHHHHHHPPP
PPPHHHHHBCCHHHHHHHHHHHHHHHHHHHHHHHHHCCSSSSSSSSCCCHHHHHHHHHHHHHHHHHHHHHHHPPP
PPPHHHHHBHCCHHHHHHHHHHHHHHHHHHHHHHHHHHCCCCCCCCCHHHHHHHHHHHHHHHHHHHHHHHHHPPP
PPPHHHHHBHHCHHHHHHHHHHHHHHHHHHHHHHHHHHHCMMCMMCSCHHHHHHHHHHHHHHHHHHHHHHHHPPP
PPPHHHHHBHHCHHHHHHHHHHHHHHHHHHHHHHHHHHCMMMMMMCSCHHHHHHHHHHHHHHHHHHHHHHHHPPP
PPPHHHHHBBHCHHHHHHHHHHHHHHHHHHHHHHHHHCCMMCMMMCSSCHHHHHHHHHHHHHHHHHHHHHHHPPP
PPPHHHHHHBCCHHHHHHHHHHHHHHHHHHHHHHHDCCMMMMMMMMCSCHHHHHHHHHHHHHHHHHHHHHHHPPP
PPPHHHHHHCCBHHHHHHHHHHHHHHHHHHHHHHHCSCMMMCMMMMCSCCHHHHHHHHHHHHHHHHHHHHHHPPP
PPPHHHHHCCHBHHHHHHHHHHHHHHHHHHHHHHHCSSCCMMMMMCSSSSCHHHHHHHHHHHHHHHHHHHHHPPP
PPPHHHHHCHHBHHHHHHHHHHHHHHHHHHHHHHHCCCAAACCCCCSSSSCHHHHHHHHHHHHHHHHHHHHHPPP
PPPHHHHHCHHBHHHHHHHHHHHHHHHHHHHHHHHHHCCAAAAAACSSSCHHHHHHHHHHHHHHHHHHHHHHPPP
PPPHHHHHCHBBHHHHHHHHHHHHHHHHHHHHHHHHHHCAACCAAACCCHHHHHHHHHHHHHHHHHHHHHHHPPP
PPPHHHHHCCBHHHHHHHHHCCCCCCCCCCHHHHHCCCCSCHHCAAACHHHHHHHHHHHHHHHHHHHHHHHHPPP
PPPHHHHHBCCHHHHHHHHCCSSSSSSSSCCHHHCCSSSSCHHHCSSCHHHHHHHHHHHHHHHHHHHHHHHHPPP
PPPHHHHHBHCCHHHHCCCCSSSSSSSSSSCHHHCBBBBBCHHCSSSCHHHHHHHHHHHHHHHHHHHHHHHHPPP
PPPHHHHHBHHCHHHCCSSSSSHHHHHHHSCCCCCCCCCCHHHCSSBSCHHHHHHHHHHHHHHHHHHHHHHHPPP
PPPHHHHHBHHCHHHCSSSSSHHHHHHHHSSSSSSSSSSCCHHCBBBBCHHHHHHHHHHHHHHHHHHHHHHHPPP
PPPHHHHHBBCCCCCCSSHHHHHHHHHHHHSSSSSSSSSSCCCHCCCCHHHHHHHHHHHHHHHHHHHHHHHHPPP
PPPHHHHHHCCSSSSSSHHHHHHHHHHHHHHHHHHHHHHSSSCCCCCCCCCCCCCCCCCCCCCCCCCCCCCCPPP
PPPHHHHHHCBSSSSSSHHHHHHHHHHHHHHHHHHHHHHHHSSSSSSSSSSSSSSSSSSSSSSSSSSSSSSSPPP
PPPPPPPPPPPPPPPPPPPPPPPPPPPPPPPPPPPPPPPPPPPPPPPPPPPPPPPPPPPPPPPPPPPPPPPPPPP
PPPPPPPPPPPPPPPPPPPPPPPPPPPPPPPPPPPPPPPPPPPPPPPPPPPPPPPPPPPPPPPPPPPPPPPPPPP
PPPPPPPPPPPPPPPPPPPPPPPPPPPPPPPPPPPPPPPPPPPPPPPPPPPPPPPPPPPPPPPPPPPPPPPPPPP
PPPPPPPPPPPPPPPPPPPPPPPPPPPPPPPPPPPPPPPPPPPPPPPPPPPPPPPPPPPPPPPPPPPPPPPPPPP
000020000000000000000000000000000000000000000000000000000000000000000000000
000000000000000000000000000000000000000000000000000000000000000000000000000
000000000000000000000000000000000000000000000000000000000000000000000000000
000333333333333333333333333333333333333333333355333333333333333333333333000
000333333333333333333333333333333333333333333553333333333322333333333333000
000333333333553322233333333322222233333333335553333333332223333333333333000
000333335553223333333333333223333333333333355533333333332233333333333333000
000333555333332233333333332233333333333333555333333333322333333333333333000
000355533333332333355333322333333333353333333333333333323333333333333333000
000553333333333333553333323333333355553333333333333333223333333532233333000
000333333333333355533333333333335555333333333333333333233333333522333333000
000333333333333333333333333333355553333333333333333333233333335523333333000
000333333333333333333333333335555533333333333333333333333333335223333335000
000333333333333333333332333333333333333333333333333333333333555233333335000
000333333333333333333322333333333333333333333333333333333335553233333355000
000333333333333333333223553332222333333333333333333333335555553333333553000
000333333333333333333335533333333233333333333333333333333355333333335533000
000333333333333333333335333333333223333333333333333333333333333335555333000
000333333333333333333333333333333333333333333333333333333333333333333333000
000333333333333333333333333333333333333333333333333333333333333333333333000
000333333333333333333333333333333333333333333333333333333333333333333333000
000333333333333333333333333333333333333333333333333333333333333333333333000
000333333333333333333333333333333333333333333333333333333333333333333333000
000333333333333333333333333333333333333333333333333333333333333333333333000
000333333333333333333333333333333333333333333333333333333333333333333333000
000333333333333333333333333333333333333333333333333333333333333333333333000
000333333333333333333333333333333333333333333333333333333333333333333333000
000333333333333333333333333333333333333333333333333333333333333333333333000
000333333333333333333333333333333333333333333333333333333333333333333333000
000333333333333333333333333333333333333333333333333333333333333333333333000
000333333333333333333333333333333333333333333333333333333333333333333333000
000333333333333333333333333333333333333333333333333333333333333333333333000
000333333333333333333333333333333333333331331111133333333333333333333333000
000333333333333333333333333333333333333113333331111333333333333333333333000
000333333333333333333333333333333333333333333333111133333333333333333333000
000333333333333333333333333333333333113111113333331113333333333333333333000
000333333333333333333333333333333311333333333333333313333333333333333333000
000333333333333333333333333333333133333311133333333331333333333333333333000
000333333333333333333333333333331331133333111133333331333333333333333333000
000333333333333333333333333333331113333333333111133313333333333333333333000
000333333333333333333333333333333333332223333333111331333333333333333333000
000333333333333333333333333333333333332233333333331131133333333333333333000
000333333333333333333333333333333333322333333333333113133333333333333333000
000333333333333333333333333333333333323333333333333311113333333333333333000
000333333333333333333333333333333222223333333333333311113333333333333333000
000333333333333333333333333333333223353333353333333331113333333333333333000
000333333333333333333333333333333225333333335333333313113333333333333333000
000333333333333333333333333333333325333333335333333311133333333333333333000
000333333333333333333333333333333323553333553333333313333333333333333333000
000333333333333333333333333333333323333333333333333333333333333333333333000
000333333333333333333333333333333323333333333333333333333333333333333333000
000333333333333333333333333333333332333333333333333333333333333333333333000
000333333333333333333333333333333333223333333333333333333333333333333333000
000333333333333333333333333333333333332233333333333333333333333333333333000
000333333333333333333333333333333333333333333353333333333333333333333333000
000333333333333333333333333333333333333333333353333333333333333333333333000
000333333333333333333333333333333333333333333355333333333333333333333333000
000333333333333333333333333333333333333333333335333333333333333333333333000
000333333333333333333333333333333333533333333335333333333333333333333333000
000333333333333333333333333333333333553333333355553333333333333333333333000
000333333333333333333333333333333333333333333355553333333333333333333333000
000333333333333333333333333333333333333333333355533333333333333333333333000
000333333333333333333333333333333333333333333333333333333333333333333333000
000333333333333333333333333333333333333533333333333333333333333333333333000
000333333333333333333333333333333333555533333553333333333333333333333333000
000333333333333333333333333333333331111133335553333333333333333333333333000
000333333333333333333333333333333333333333335515333333333333333333333333000
000333333333333333333333333333333333333333331111333333333333333333333333000
000333333333333333333333333333333333333333333333333333333333333333333333000
000333333333333333333333333333333333333333333333333333333333333333333333000
000333333333333333333333333333333333333333333333333333333333333333333333000
000000000000000000000000000000000000000000000000000000000000000000000000000
000000000000000000000000000000000000000000000000000000000000000000000000000
000000000000000000000000000000000000000000000000000000000000000000000000000
000000000000000000000000000000000000000000000000000000000000000000000000000
