75
75
PPPPPPPPPPPPPPPPPPPPPPPPPPPPPPPPPPPPPPPPPPPPPPPPPPPPPPPPPPPPPPPPPPPPPPPPPPP
PPPPPPPPPPPPPPPPPPPPPPPPPPPPPPPPPPPPPPPPPPPPPPPPPPPPPPPPPPPPPPPPPPPPPPPPPPP
PPPPPPPPPPPPPPPPPPPPPPPPPPPPPPPPPPPPPPPPPPPPPPPPPPPPPPPPPPPPPPPPPPPPPPPPPPP
PPPHHHHHHHHHHHHHHHHHHHHHHHHAAHHCCHHHHHHHHHHHHHHHHHHHHHHHHHHHHCCHHHHHHCCHPPP
PPPHHHHHHHHHHHHHHHHHHHHHHHHHAAHHCCHHHHHHHHHHHHHHHHHHHHHHHHHHHHCCHHHHCCCCPPP
PPPHHHHHHHHHHCCHHHHHHHHHHHHHAAHHCCHHHHHHHHHHHHHHHHHHHHHHHHHHHHHCCHHHCCCCPPP
PPPHHHCHCHCHCCCCUHHHHHHHHHHAAHHHCCHHHHHHHHHHHHHHHHHHHHHHHHHHHHHHCCHHCCCCPPP
PPPHHCCCCCCCCHHCCHHHHCCHHHAADHHCCHHHHHHHHHHHHHHHHHHHHHHHHHHHHHHCCHHHCCHHPPP
PPPPPCCPPPPPPPPCCPPPPCCPPPPPPPPPCPPPPPPPPPHHHHHHHHHHHHHHHHHHHHHCCHHCCCCHPPP
PPPCCHHHHHHHHHHHHCCCCBBCCBCAACBBCBHHHHHHHHHHHHHBHHHHHHHHHHHHHHHHCCCCHCCHPPP
PPPHHHHHHHHHHHHHHHCHBBBBCCCCCCCCCCCCHHHHHHHHHHHHHHHHHHHHHHHHHHHHHCCCCCCHPPP
PPPHHHHHHHHHHHHHHHHHBBBBBCBCCBCCBCCCCHHHHHHHHHHHHHHHHHHHHHHHHHHHHCCCCCCHPPP
PPPHHHHHHHHHHHHHHHHHBBBBBBBBAABCCBHHCCCHHHHHHHHHHHHHHCCCUHHHHHHHCCHCCCCHPPP
PPPHHHHHHHHHHHHHHHHHBBBBBBBBAABBCCHHHCCCCCHHHHHHCCCCCCCCCCCCHCHCCCHCCHHHPPP
PPPHHHHHHHHHHHHHHHHHBBBBBBBAABBBCCHHCHCCCCCCCCCCCCCCCCAACCCCCCCCCCCHCHCCPPP
PPPHHHHHHHHHHHHHHHHHBCCCBBAACCBCCBCCCCCHHHCCCCCCHHHHHCAAAAAACHCCCCCCCCCMPPP
PPPHHHHHHHHHHHCCCCCCCCCCCCCCCCCBCCCCHCHHHHHHHHHHHHHHHAAAAAAAAHHCHCCCHCCMPPP
PPPHHHHHHHHUCCCCCCCCCBBBCCBAABCBCCHHHHHHHHHHHHHHHHHHHAAPPPPPPPPPPPPPPPPPPPP
PPPHHHHHHHCCCCHHHHHHBBBBBBBBAABCCBHHHHHHHHHHHHHHHHHHHAAAAAAAAHHHHHCCCCCMPPP
PPPHHHHCCCCCHHHHHHHHBBBBBBBBBAABCCHHHHHHHHHHHHHHHHHHHAAAAAAAAHHHHHCCHHCMPPP
PPPCCCCCCCHHHHHHHHHHBBBBBBBBBBBCCBHHHHHHHHHHHHHHHHHHHAAAAAAAAHHHHHHCCHCMPPP
PPPCCCCHHHHHHHHHHHHHBBBBBBBBBBCCBBHHHHHHHHHHHHHHHHHHHAAAAAAAAHHHHHHCCHCMPPP
PPPHHHHHHHHHHHHHHHHHBBBBBBBBBBCCBBHHHHHHHHHHHHHHHHHHHHHHHHHHHHHHHHHHCCCMPPP
PPPHHHHHHHHHHHHHHHHHHHHHHHHHHHDCCHHHDHHHHHHHHHHHHHHHHHHHHHHHHHHHHHHHCCCMPPP
PPPHHHHHHHHHHHHHHHHHHHHHHHHHHHHCCHHHHHHHHHHHHHHHHHHHHHHHHHHHHHHHHHHUCCCCPPP
PPPHHHHHHHHHHHHHHHHHHHHHHHHHHHHCCHHHHHHHHHHHHHHHHHHHHHHHHHHHHHHHHHHCCCCHPPP
PPPHHHHHHHHHHHHHHHHHHHHHHHHHHHHCCHHHHHBBBBBBBBBBBBBBBBHHHHHHHHHHHHHHHCCHPPP
PPPHHHHHHHHHHHHHHHHHHHHHHHHHHHCCHHHHHHBBBBBHBBBBBBBBBBHHHHHHHHHHHHHHCCCCPPP
PPPHHHHHHHHHHHHHHHHHHHHHHHHHHHHCCHHHHHBBBBBBBBBBBBBBBBHHHHHHHHHHHHHHHCCCPPP
PPPHHHHHHHHHHHHHHHHHHHHHHHHHHHCCHHHHHHBBBBBBBBBBBBBBBBHHHHCCCCCCCCCCCHCCPPP
PPPMMMMMMMMMMMMMMMHMMMMMMMMMMMCMMMMMMMMMMMMMMMMMMMMMMMMMMMMMMMMMMCMMMMMMPPP
PPPCCCCCCHHHHHHHHHHHHHHHHHHHCCAAHHHHHHBBBBBBBBBHBBBBBBHHHHCMCCCCCCCMCCCHPPP
PPPHCCHHCCHHHHHHHHHHHHHHHHHHHCCHHHHHHHBBBBBBBBBBBBBBBBHHHHCMCCCCCCCMCCCHPPP
PPPHHHHHHCCHHHHCCCHHHHHHHHHHCCHHHHHHHHBBBBBBBBBBBBBBBBHHHHCMCCCCXCCMCHCCPPP
PPPHHHHHHHCCCCCCCCCHHHHHHHHCCAAHHHHCHCCBBBBBBBBBBBBBBBCHHHCMCCCCCCCMCHHCPPP
PPPHHHHHHHHCCCCHHHCCCCCHHHHHCCAAHHCCCCCCBBBBBBBBBBBBBCCCCCCMCCCCCCCMCHCCPPP
PPPHHHHHHHCHHHHHHHHCCCCCHHCHCCHAACCHCHBCCCBBCCBBBBBBCCHCCCCMCCCCCCCCCCCHPPP
PPPHHHHHHCCCHHHHHHHHHHHCCCCCCHCHCCHHHHBBCCCCCCCCBBBCCBHHHHCMCCCCCCCMCCCCPPP
PPPCHHHCCCHCCHCHHHHHHHHHCCHCCCCCCHHHHHBBBBCCBBCCCCCCBBHHHHCMMMMMMMMMCHHCPPP
PPPCCCCCCHHHCCCCCHCHHCHHHHHHHCHCAAHHHHBBBBBBBBBBCCCBBBHHHHCCCCCCCCCCCHCCPPP
PPPHCCCHHHHHHCHCCCCCCCCCCHHHCCHAAHHHHHBBBBBBBBBBBBBBBBHHHHHHHHHHHHHHCCHCPPP
PPPHHHHHHHHHHHHHHCHCCHCCCCHHCCCHAAHHHHBBBBBBBBBBBBBBBBHHHHHHHHHHHHHCCHCCPPP
PPPHHHHHHHHCCCCCCCCCCCHHHCCCCCCCAACHHHHHHHHHHHHHHHHHHHHHHHHHHHHHHHHHCCHCPPP
PPPHHHHHHHHCMMMMMMMMMCHHHHCCCCHCCCCCHHHHHHHHHHHHHHHHHHHHHHHHHHHHHHHHCCHHPPP
PPPHHHHHHHHCMCCCCCCCMCHHHHHCCHHHCCHCCCHCHHHHHHHHHHHHHHHHHHHHHHHHHHHCCHHCPPP
PPPHHHHHHHHCMCCCCCCCMCHHHHHHCCHAAHHHCCCCCHCHHCCHCHHHHHHHHHHHHHHHHHHHCCHHPPP
PPPHHHHHHHHCMCCCCCCCCCHHHHHHHCCAADHHHUCHCCCCCCCCCCHHHHHHHHHHHHHHHHHCCHHCPPP
PPPHHHHHHHHCMCCCCCCCMCHHHHHHCCHAAHHHHHHHHCHCCHHCHCCHHHHHHHHHHHHHHHCCHHHHPPP
PPPHHHHHHHHCMCCCCCCCMCHHHHHCCHAAHHHHHHHHHHHHHHHHHHCCHHHCCHHHHHHHHHHCCHHHPPP
PPPHHHHHHHHCMCCCCCCCMCHHHHHHCCHHHHHHHHHHHHHHHHHHHHHCCHCCCCHHHHHHHHHHHCHHPPP
PPPHHHHHHHHCMCCCCCCCMCHHHHHHHCCHHHHHHHHHHHHHHHHHHHHHCCCHHCCHHCCCCUCCCCCCPPP
PPPHHHHHHHHCMMMMMMMMMCHHHHHHCCHHHHHHHHHHHHHHHHHHHHHHHCHHHHCCCCCCCCCCCHCCPPP
PPPHHHHHHHHCCCCCXCCCCCBBCCCCCCCCCCCHHHHHHHHHHHHHHHHHHHHHHHHCCHHHHCHHCCHHPPP
PPPHHHHHHHHHHHHHHHBBBBBBCMMMMMMMMMCHHHHHHHHHHHHHHHHHHHHHHHHHCHHHCHHHCCHHPPP
PPPHHHHHHHHHHHHHHHBBBBBBCMCCCCCCCMCHHHHHHHHHHHHHHHHHHHHHHHHCCCCCCCHCHCCCPPP
PPPHHHHHHHHHHHHHHHBBBBBBCMCCCCCCCMCHHHHHHHHHHHHHHHHHHHHHHHCCHCCCBCCCCCBCPPP
PPPHHHHHHHHHHHHHHHBBBBBBCMCCCCCCCCCHHHHHHHHHHHHHHHHHHHHCHCCHHHBBBBCBBCCBPPP
PPPHHHHHHHHHHHHHHHBBBBBBCMCCCCCCCMCHHHHHHHHHHHHHHHCHHHCCCCHHHHBBBBBBBCCBPPP
PPPHHHHHHHHHHHHHHHBBBBBBCMCCCCCCCMCHHHHHHHHHHHHHHCCCCCCHCHHHHHBBBBBBCCBBPPP
PPPHHHHHHHHHHHHHHHBBBBBBCMCCCCCCCMCHHHHHHHHHHHHCCCHCCCHHHHHHHHBBBBBBCCBCPPP
PPPHHHHHHHHHHHHHHHBBBBBBCMCCCCCCCMCHHHHHHHCCHCCCCHHHHHHHHHHHHHBBBBBCCBCCPPP
PPPHHHHHHHHHHHHHHHBBBBBBCMMMMMMMMMCHHHHHHCCCCCCHHHHHHHHHHHHHHHBBBBBBBCCBPPP
PPPHHHHHHHHHHHHHHHHHHHHHCCCCCCCCCCCCHHHCCCHHCHHHHHHHHHHHHHHHHHBBBBBBCCCCPPP
PPPHHHHHHHHHHHHHHHHHHHHHHHHHCCHHHHCCCHCCCHHHHHHHHHHHHHHHHHHHHHBBBBBCCBBCPPP
PPPHBBBBBBBBBBBBBBHCHCHHHCHCCAAHCCCHCCCHHHHHHHHHHHHHHHHHHHHHHHBBBBBCCBCCPPP
PPPHBBBBCBBBCCBBBBCCCCCHCCCCAACCCCHHHCHHHHHHHHHHHHHHHHHHHHHHHHBBBBBCCBBCPPP
PPPHBBBCCCBCCCCBBCCHCHCCCCCAAHCCUHHHHAHHHHHHHHHHHHHHHHHHHHHHHHBBBBBCCBCCPPP
PPPHCBCCBCCCBBCCCCHHHHHCCCHHAAHHHHHHAAAAHHHHHHHHHAHHHHHHHHHHHHBBBBCCBCCBPPP
PPPCCCCBBBCBBBBCCBHHHHHCCHAAAAAHHAHAAHAAAHHHHHHAAAAHHHHHHHHHHHBBBBBCCCCBPPP
PPPCBCBBBBBBABBBBBHAHAAHCCAAHAAAAAAAHHHHAAHHAAAAAHAAAAHHHHHHHABAABBBBCCCPPP
PPPHBBBBBBBAAAABBAAAAAACCHHCCAHAAHAHHHHHHAAAAAAHHHHAAAAAHHAAAAAAAABBCCCCPPP
PPPPPPPPPPPPPPPPPPPPPPPPPPPPPPPPPPPPPPPPPPPPPPPPPPPPPPPPPPPPPPPPPPPPPPPPPPP
PPPPPPPPPPPPPPPPPPPPPPPPPPPPPPPPPPPPPPPPPPPPPPPPPPPPPPPPPPPPPPPPPPPPPPPPPPP
PPPPPPPPPPPPPPPPPPPPPPPPPPPPPPPPPPPPPPPPPPPPPPPPPPPPPPPPPPPPPPPPPPPPPPPPPPP
PPPPPPPPPPPPPPPPPPPPPPPPPPPPPPPPPPPPPPPPPPPPPPPPPPPPPPPPPPPPPPPPPPPPPPPPPPP
000000000000000000000000000000000000000000000000000000000000000000000000000
000000000000000000000000000000000000000000000000000000000000000000000000000
000000000000000000000000000000000000000000000000000000000000000000000000000
000111111111111111111111111111122111111111111111111111111111122111111221000
000111111111111111111111111111112211111111111111111111111111112211112222000
000111111111122111111111111111112211111111111111111111111111111221112222000
000111212121222211111111111111112211111111111111111111111111111122112222000
000112222222211221111221111111124111111111111111111111111111111221112211000
000002200000000220000220000000004000000000222121212111111111111221122221000
000221111111111112222332232112332311111111111112111111111111111122221221000
000111111111111111213333222222222222111111111111111111111111111112222221000
000111111111111111113333323223223222211111111111111111111111111112222221000
000111111111111111113333333311322311222111111111111112221111111122122221000
000111111111111111113333333311332211122222111111222222222222121222122111000
000111111111111111113333333113332211212222222222222222112222222222212122000
000111111111111111113222331122322322222111222222111112111111212222222222000
000111111111112222222222221122232222121111111111111111111111111212221222000
000111111111222222222333223113232211111111111111111111100000000000000000000
000111111122221111113333333311322311111111111111111111111111111111222222000
000111122222111111113333333331132211111111111111111111111111111111221122000
000222222211111111113333333333322311111111111111111111111111111111122122000
000222211111111111113333333333223311111111111111111111111111111111122122000
000111111111111111113333333333223311111111111111111111111111111111112222000
000111111111111111111111111111122111111111111111111111111111111111112222000
000111111111111111111111111111122111111111111111111111111111111111112222000
000111111111111111111111111111122111111111111111111111111111111111122221000
000111111111111111111111111111122111113333333333333333111111111111111221000
000111111111111111111111111111221111113333313333333333111111111111112222000
000111111111111111111111111111122111113333333333333333111111111111111222000
000111111111111111111111111111221111113333333333333333111122222222222122000
000222222222222222122222222222222222222222222222222222222222222222222222000
000222222111111111111111111122111111113333333331333333111122222222222221000
000122112211111111111111111112211111113333333333333333111122222222222221000
000111111221111222111111111122111111113333333333333333111122222222222122000
000111111122222222211111111221111112122333333333333333211122222222222112000
000111111112222111222221111122111122222233333333333332222222222222222122000
000111111121111111122222112122111221213222332233333322122222222222222221000
000111111222111111111112222221212211113322222222333223111122222222222222000
000211122212212111111111221222222111113333223322222233111122222222222112000
000222222111222221211211111112121111113333333333222333111122222222222122000
000122211111121222222222211122111111113333333333333333111111111111112212000
000111111111111112122122221122211111113333333333333333111111111111122122000
000111111112222222222211122222221121111111111111111111111111111111112212000
000111111112222222222211112222122222111111111111111111111111111111112211000
000111111112222222222211111221112212221211111111111111111111111111122112000
000111111112222222222211111122111111222221211221211111111111111111112211000
000111111112222222222211111112211111112122222222221111111111111111122112000
000111111112222222222211111122111111111112122112122111111111111111221111000
000111111112222222222211111221111111111111111111112211122111111111122111000
000111111112222222222211111122111111111111111111111221222211111111111211000
000111111112222222222211111112211111111111111111111122211221122221222222000
000111111112222222222211111122111111111111111111111112111122222222222122000
000111111112222222222233222222222221111111111111111111111112211112112211000
000111111111111111333333222222222221111111111111111111111111211121112211000
000111111111111111333333222222222221111111111111111111111112222222121222000
000111111111111111333333222222222221111111111111111111111122122232222232000
000111111111111111333333222222222221111111111111111111121221113333233223000
000111111111111111333333222222222221111111111111112111222211113333333223000
000111111111111111333333222222222221111111111111122222212111113333332233000
000111111111111111333333222222222221111111111112221222111111113333332232000
000111111111111111333333222222222221111111221222211111111111113333322322000
000111111111111111333333222222222221111112222221111111111111113333333223000
000111111111111111111111222222222222111222112111111111111111113333332222000
000111111111111111111111111122111122212221111111111111111111113333322332000
000133333333333333121211121221112221222111111111111111111111113333322322000
000133332333223333222221222211222211121111111111111111111111113333322332000
000133322232222332212122222111221111111111111111111111111111113333322322000
000123223222332222111112221111111111111111111111111111111111113333223223000
000222233323333223111112211111111111111111111111111111111111113333322223000
000232333333133333111111221111111111111111111111111111111111113113333222000
000133333331111331111112211221111111111111111111111111111111111111332222000
000000000000000000000000000000000000000000000000000000000000000000000000000
000000000000000000000000000000000000000000000000000000000000000000000000000
000000000000000000000000000000000000000000000000000000000000000000000000000
000000000000000000000000000000000000000000000000000000000000000000000000000

