30
30
PPPPPPPPPPPPPPPPPPPPPPPPPPPPPP
PPPPPPPPPPPPPPPPPPPPPPPPPPPPPP
PPPPPPPPPPPPPPPPPPPPPPPPPPPPPP
PPPSSCPPPUSSPPPSSSPPPSSSPPPPPP
PPPSSCCPPPCSSPPPSSSPPPSSSPPPPP
PPPSCSCCPPPCSSPPPSSSPPPSSSPPPP
PPPCSSSCCPPPCCSPPPSSSPPPSSSPPP
PPPSCSSSCCPPPCCSPPPSSSPPPSSPPP
PPPSSCSSSCCPPPCSSPPPSSSPPPSPPP
PPPSCSSSSSCCCCCSSSSSSSSSSSSPPP
PPPCSSSSSSSSCSSSSSSSSSSSSSSPPP
PPPSCSSSSSSCCSPPPSSSPPPSSSPPPP
PPPSSCPPPSSCPPPSSSPPPSSSPPPPPP
PPPSCSSPPPSCCPPPSSSPPPSSSPPPPP
PPPCSSSSSSSSCCCCCSSSSSSSSSSPPP
PPPSCSSSSSSSSSSSCCCCSSSSSSSPPP
PPPSSCSSSSPPPSSSPPPCSSPPPSSPPP
PPPSCSSSSSSPPPSSSPPPCSSPPPSPPP
PPPSCSSSSSSSPPPSSSPPPCSSPPPPPP
PPPCSSSSSSSSSPPPSSSPPPCSSPPPPP
PPPSCSSSSSSSSSPPPSSSPPPCSSPPPP
PPPSCSPPPSSSPPPSSSPPPSSCPPPPPP
PPPSSUSPPPSSSPPPSSSPPPSSCPPPPP
PPPSCSSSPPPSSSPPPSSSPPPSSCPPPP
PPPSCSSSSPPPSSSPPPSSSPPPCSUPPP
PPPCSSSSSSSSSSSSSSSSSSSCSSSPPP
PPPSCSSSSSSSSSSSSSSSSSCSSSSPPP
PPPPPPPPPPPPPPPPPPPPPPPPPPPPPP
PPPPPPPPPPPPPPPPPPPPPPPPPPPPPP
PPPPPPPPPPPPPPPPPPPPPPPPPPPPPP
111111111111111111111111111111
111111111111111111111111111111
111111111111111111111111111111
111111111111111111111111111111
111111111111111111111111111111
111111111111111111111111111111
111111111111111111111111111111
111111111111111111111111111111
111111111111111111111111111111
111111111111111111111111111111
111111111111111111111111111111
111111111111111111111111111111
111111111111111111111111111111
111111111111111111111111111111
111111111111111111111111111111
111111111111111111111111111111
111111111111111111111111111111
111111111111111111111111111111
111111111111111111111111111111
111111111111111111111111111111
111111111111111111111111111111
111111111111111111111111111111
111111111111111111111111111111
111111111111111111111111111111
111111111111111111111111111111
111111111111111111111111111111
111111111111111111111111111111
111111111111111111111111111111
111111111111111111111111111111
111111111111111111111111111111
