40
40
PPPPPPPPPPPPPPPPPPPPPPPPPPPPPPPPPPPPPPPP
PPPPPPPPPPPPPPPPPPPPPPPPPPPPPPPPPPPPPPPP
PPPPPPPPPPPPPPPPPPPPPPPPPPPPPPPPPPPPPPPP
PPPHHHHHHHHHHHHHHHHHHHHHHHHHHHHHHHHHHPPP
PPPSSSSSSSSSSSSSHHHHHHHHHHHHHHHHHHHHHPPP
PPPSSHHHHHHHHHHSSSSSSSSSSSSSSSSHSSSHHPPP
PPPHSHHHHHHHHHHHHHHHHHHHHHHHHHHHHHSHHPPP
PPPHSSSSCCCHSHHHHHHHHHSSSHHHHHHHHHSHHPPP
PPPHHHHCCCCHHSSSHHSSSSHHSHHHHHHHHHSHHPPP
PPPHHHHHCCCCCCCSSSSHHHHHSHHHHHHHHHSHHPPP
PPPHHHHHCHHHHCCHHHHHHHHHSSHHHHHHHHSHHPPP
PPPHHHHHCCHHBCCHHHHAAAAAASHHHHHHHHSHHPPP
PPPHHHHCCHHBHCCHHHHHAAAAASHHHHHHHHSHHPPP
PPPHHHCCHHCCCCHHCCCHAAAAASSHHHHHHHSHHPPP
PPPHHHCCHHHBHUBCCHCHAAAAAASSHHHHHHSHHPPP
PPPHHCCCHHHBHUHCHHCHAAAAAAASSHHHHHSHHPPP
PPPHHCHHHHHBHHHCHHCHAAAAAAAAHSHHHHSHHPPP
PPPHHCHBBBBBHHHCHHCCCCCHHHHHHHSHHHSHHPPP
PPPHHCHHBBHHHCCCHHHHHHCCCHHHHHSSSSSHHPPP
PPPHHCHHBHHCCCHHHHHHHHHHCCHHHCCCCCCHHPPP
PPPHHHCHHHHCBHBBHHBBHBBHHCCCCHHHHBCHHPPP
PPPHHHCCCHCCHHBBHHHBHBHHHHHHHHHHHBCHHPPP
PPPHHHHHCCCHHHHHHHHBBBHHHHHHHBBBBBCHHPPP
PPPHHHHHHHHHDHHHHHHHBBHHHHHHBBHHHHCHHPPP
PPPHHCCHHHHHHCCCCCHHHBBHHHHBHHHHHHCHHPPP
PPPHHCCCHHHHHCHHHCCCHHHBHHHBHHHHHHCHHPPP
PPPHHCHCHHHHHCHHHHHHCCHBBBBBHHHHHHCCHPPP
PPPHHCHHCHHHHCHAAHHHHCHHHHHHHHHHHHHCHPPP
PPPHHCHHCCHHHCHHAAAHHCHHHHHHDHHHDHHCHPPP
PPPHHCHHHCCCHCHHAAHHHHCHHHHHHHHHHHHCHPPP
PPPHHHCHHHHCCCHHAAHHHHHCCCCCCCCHHHHCHPPP
PPPHHHCHHHHHHHHHAAAAAHHHHHHHHHHCCHHCHPPP
PPPHHHCHHHHHHHHHAAAHAAAAHHHXHHHHCCHCHPPP
PPPHHHCHHHHHHHHHAHHHHHHHHHHHHHHHHCCCHPPP
PPPHHHCCCHCCHHHAAHHHHHHHHHHHHHHHHHHHHPPP
PPPHHHHHCCCHHHHHHHHHHHHHHHHHHHHHHHHHHPPP
PPPHHHHHHHHHHHHHHHHHHHHHHHHHHHHHHHHHHPPP
PPPPPPPPPPPPPPPPPPPPPPPPPPPPPPPPPPPPPPPP
PPPPPPPPPPPPPPPPPPPPPPPPPPPPPPPPPPPPPPPP
PPPPPPPPPPPPPPPPPPPPPPPPPPPPPPPPPPPPPPPP
0000000000000000000000000000000000000000
0000000000000000000000000000000000000000
0000000000000000000000000000000000000000
0001111111111111111111111211111111111000
0001222222222222222222222222211111111000
0001111111111111122111112211222111111000
0001115555555555111121122122211121111000
0001155666665555512112122122122222111000
0001556677777666511212122222221212111000
0001567778888776511221122222222222121000
0001567788998876511112222222222212111000
0005567778998876555111111222211221111000
0005667778998877655511111211222221111000
0005666678998887655511111222222222111000
0005666678888877665511111122222221111000
0005666677777776655511111112221111211000
0005666666666666655511111111333111111000
0005666666666666444444444444444331111000
0005555666666666455444444444444431111000
0005556666666665544444444444444433311000
0005555566666665555444444444444433331000
0005555666666665554444444444444444431000
0003555666666665554444444444444444431000
0003555556666655444444444444444444333000
0003335555555555444444444444444444333000
0003334455555555444444444444444444333000
0003333444444444444444444444444444433000
0003333331333331144444444444444444133000
0003333333133333111444444444444444133000
0003333333113333114444444444444441133000
0003333333133313114444444444444441133000
0003333331133313111114444444444433133000
0001133311333333111311114444444333333000
0001331311333333133333344444433333333000
0001333333311331133313331111133333133000
0001111111311333313311311111133133133000
0001111111333333333333333333333333333000
0000000000000000000000000000000000000000
0000000000000000000000000000000000000000
0000000000000000000000000000000000000000
