100
100
PPPPPPPPPPPPPPPPPPPPPPPPPPPPPPPPPPPPPPPPPPPPPPPPPPPPPPPPPPPPPPPPPPPPPPPPPPPPPPPPPPPPPPPPPPPPPPPPPPPP
PPPPPPPPPPPPPPPPPPPPPPPPPPPPPPPPPPPPPPPPPPPPPPPPPPPPPPPPPPPPPPPPPPPPPPPPPPPPPPPPPPPPPPPPPPPPPPPPPPPP
PPPPPPPPPPPPPPPPPPPPPPPPPPPPPPPPPPPPPPPPPPPPPPPPPPPPPPPPPPPPPPPPPPPPPPPPPPPPPPPPPPPPPPPPPPPPPPPPPPPP
PPPAAAAAAAAAAAAAAAAAAAAAAAAAAAAAAAAAAAAAAAAAAAAAAAAAAAAAAAAAAAAAAAAAAAAAAAAAAAAAAAAAAAMMMMMMMMMMMPPP
PPPAAAAAAAAAAAAAAAAAAAAAAAAAAAAAAAAAAAAAAAAAAAAAAAAAAAAAAAAAAAAAAAAAAAAAAAAAAAAAAAAAAMMMMMMMMMMMMPPP
PPPAAAAAAAAAAAAAAAAAAAAAAAAAAAAAAAAAAAAAAAAAAAAAAAAAAAAAAAAAAAAAAAAAAAAAAAAAAAAAAAAAMMMMMMMMMMMMMPPP
PPPAAAAAAAAAAAAAAAAAAAAAAAAAAAAAAAAAAAAAAAAAAAAAAAAAAAAAAAAAAAAAAAAAAAAAAAAAAAAAAAAAMMMMMMMMMMMMMPPP
PPPAAAAAAAAAAAAAAAAAAAAAAAAAAAAAAAAAAAAAAAAAAAAAAAAAAAAAAAAAAAAAAAAAAAAAAAAAAAAAAAAAMMMMMMMMMMMMMPPP
PPPAAAAAAAAAAAAAAAAAAAAAAAAAAAAAAAAAAAAAAAABCXCBAAAAAAAAAAAAAAAAAAAAAAAAAAAAAAAAAAAAMMMMMMMMMMMMMPPP
PPPAAAAAAAAAAAAAAAAAAAAAAAAAAAAAAAAAAAAAHHABBCBBBAAAAASCAACAAAAAAAAAAAAAAAAAAAAAAAAMMMMMMMMMMMMMMPPP
PPPAAAAAAAAAAAAAAAAAAAAHAAAAAAAAAAAAAAHHHBHAHAHAHBAACSSCSSCAAAASSSAAAAAAAAAAAAAAAAMMMMMMMMMMMMMMMPPP
PPPAAAAAAAAAAAAAAAAAAHHHHAAAAAAAAAAACCCCBHBHAHAHACCCBCCCCCSSSSSSSSSBBAAAAAAAAAAAAAMMMMMMMMMMMMMMMPPP
PPPAAAAAAAAAAAAAAAAAHHBHHHHHHHAAAAACCSSSDSSBHAHACDDSSSSSSSCCCCSSSBBBAAAAAAAAAAAAAMMMMMMMMMMMMMMMMPPP
PPPAAAAAAAAAAAAAAHHHHHHHHBHHHHHAACCSSSSSSSSSSBACDSSSSSSSSSSSSCCCAAAABHAAAAAAAAAAAMMMMMMMMMMMMMMMMPPP
PPPAAAAAAAAAAAAAHHBHHHAAHHHHHHSACCSSSSSSSSSSBHADSSSSSSSSSSSSSAAACBBBHAAAAAAAAAAAAMMMMMMMMMMMMMMMMPPP
PPPAAAAAAAAAAAAAHHHHHSSSSSHHHSSSCSSSSSSSSSSBBAUCSSSSSSSSSSSCASSSCCBBHAAAAAAAAAAAAMMMMMMMMMMMMMMMMPPP
PPPAAAAAAAAAAAAAHHBHHSSXCCCCCCCCCSSSSSSSAAAAACSCSSSSSSSSSSSCASSSSSCBHAAAAAAAAAAAAMMMMMMMMMMMMMMMMPPP
PPPAAAAAAAAAAHHHHHHHHHHHHHHHSSSSSSSSSSAAACCCCSSSCACCCCSSSSSCASSSSSSCCAAAAAAAAAAAAMMMMMMMMMMMMMMMMPPP
PPPAAAAAAAAABBHHBHHHHHHHHHHHBBBBDDSSSSASACSSSSSSACSSSCSSSSSCASSSSSSBBCAAAHSSHAAAAMMMMMMMMMMMMMMMMPPP
PPPAAAAAAABBBBHHHHHBHHHHHHHBBBBBBDDSSSAAACSSSSSSSSSSSCSSSSSCASSSSSSSSBCCAAHHAAAAAAMMMMMMMMMMMMMMMPPP
PPPAAAAAAABHBBBBBHHHHHHHAAHHHHBBBBDDSSASSCSSSSSSSSSSSCSSSSSCASSSSSSSSSBCCAAAAAAAAAAMMMMMMMMMMMMMMPPP
PPPAAAAAAABHHBBBBBAAAAAAAAAAAAAAHBBBSSASSCSSSSSSSSSSSCSSSSSCASSSSSSSSSBBCAAAAAAAHHAAMMMMMMMMMMMMMPPP
PPPAAAAAAABBHHBHBAAAAHAAAAHAAAAAAAHBSSASSCSSASSAASSSSUCCSSSCASSSSSSSCCCCCAAAAAAAAAAAMMMMMMMMMMMMMPPP
PPPAAAAAAABBBBBBAAAAAAAAAAAAAAAAAAAASSASSXSAAAAAASSSSCCDCCCASSSSSSSCCSSSCCBBBSSSSSAAMMMMMMMMMMMMMPPP
PPPAAAAAAAHHBBBBAAAAAAAAHHAAAAAAAAAAAABBBSSSSSSASSSSSSSSSSCASSSSSSSCSSCCBBBBBBBBBBSAAMMMMMMMMMMMMPPP
PPPAAAAAAAABBHHAAAAAAAAADHHAAAAAAHAAAABBSSSSSSSAASSSSSSSSSCSSSSSSSSCSCBBBBHHBBHBABBBBMMMMMMMMMMMMPPP
PPPAAAAAAAAABHBAAHHAAAAADHHHHHAAAAAAAABBBSSSSSSASSSSSSSSSSCSSSSSSSSCSSCBBBBBBBHHAAABBMMMMMMMMMMMMPPP
PPPAAAAAAAAABHBAAHHAAAAAAAAHHHAAAAAAAAABBBSSBBASSSSSSSSSSSCSSSSSSSSCSSCBHBBBBBBBAABHHMMMMMMMMMMMMPPP
PPPAAAAAAAABBBBAAAAAAAAAAAAAAAAAAAAAAAAAHHSBBABSSSSSSSSSSSCSSSSSSSSCSSCHHBBBHHBBHHHHMMMMMMMMMMMMMPPP
PPPAAAAAAABBHHBAAAAAAAAAAAAAAAAAAAAAAAAAHHBBABBSSSSSSSSSSSCSSSSSSSSCSUBBBBHHHBBHHHBBMMMMMMMMMMMMMPPP
PPPAAAAAAACCBBBAAAAAAAAAAAAHAAAAAAAHAABAHHBBAHBBSSSSSSSSSXCSSSSSSSSCSCCBBHHHHBHHHHBBMMMMMMMMMMMMMPPP
PPPAAAAAAAACBBAAAAAAAAAAAAHHAAAAAAAHHHDAUDBABHBBSSSSSSSSSSSSSSSSSSCSSCCCBBHHHHHHHHHHMMMMMMMMMMMMMPPP
PPPAAAAAAAACCAAAAAAAAAAAAAAHAAAAXHHHHHUADXBABHBSSSSSSSSSSSSSSSSSSSCSSCBBBBHHHHHHCUHHHMMMMMMMMMMMMPPP
PPPASAAAAAAACCAAAAAAAAAAAAAAAAACBBBBBBBAAAABHHBSSSSSSSSSSSSSSSSSSCSSSCCBBHHHHHHHCHHHBHHBBMMMMMMMMPPP
PPPAAAAAAAABBCAHHHAAAAAAAAAACCCBBBBBBAAAXDBBHBSSSSSSSSSSSSSSSSSSSCSSSSCCBBHHHHHHCHHBBBBBBBMMMMMMMPPP
PPPAAAHAAAABBCAAAAAAACCCCCCCCBBBBBAAAABBBBBHHBSSSSSSSSSSSSSSSSSSCSSBBSSCCCHHHHAUCHHBABHBBMMMMMMMMPPP
PPPAAAHHAAABBCCAAAAACBBBBBBBBBBAAAABBBBBBBBSBSSSSSSSSSSSSSSSSSSCSSBBBBBBSCBHHHHHBHHBSHHBBMMMMMMMMPPP
PPPAAAAAAAABBBCDXDUCBBBBBBHBBBAABBBBBSBHHBBSSBSSSSSSSSSSSSSSCCCCBBBABBBSSCSSBBSSBBBBBHBBMMMMMMMMMPPP
PPPAAAAAAAAAAAAAAAAAAAAAAAAAAAABBBHHSSSHHHBSBBBBBBBCCCSSSSSSCAABBBBBBBSSCCBBABSSSSBBBBBBMMMMMMMMMPPP
PPPSSAAAAAABBBBXDUDBBBBBBBBBBBABBBHHHBBBBHHHSHHBBBCBBCSSSSSCSSSAAABBBCCCCSSSSBBBSSSSSSBBBMMMMMMMMPPP
PPPSAAAAAAAAHHBCCCCCCCCCCCCCBBABBBHHHBBBBBBBBBHBBCBBBCCSCCCSSBBBBBAAAHHACCCCCCCCCCSSSSSSSSMMMMMMMPPP
PPPSAAAAAAAAAHBCBBBBCBBBBBCCCBABBBBBBBBBBBBBBBBBCBBBBBBCCSSSBBBBHBBBHHHHAAHAAAAAAASSSSSSSBBBMMMMAPPP
PPPSAAAAAAAAAHCBBBBBCBBBBCBBCCACCCCCCCXCCBBBBBCCBBBBBBBSSSSBBBSHHBBUCHHHHHAHHHHHHAAASSSSBBHBBMMAAPPP
PPPAAAAAAXCCUCBBBBBBCBBBBBBBBBABBBHBBBDCCXCCCCCBCBBBSBBBBSSSBBSBBBBCSCHHHHHHHHHHHHHAAAAAAABBMAAAAPPP
PPPAAAAADCCBBBBBBBBCHHHHSHHSBBABBBHBBBBBBBBCCCBSCBBSUCBBBHBSBBBBBBCCHSCCCCCCSSSHHHHHHHHHHHAAAAAAAPPP
PPPAAAAAACCBBBBBBBCCCCHHSHHCCBABBBHHBBBBBBBCCCMMMCCBBBCBBHBBSBBBBCCHHHSSHHHHSSSHHSHHHSSHHHAAAAAAAPPP
PPPAAAAAAACASHHHHHHHHHHHHHHCXAAUCBBHHHBBSSMXMMMPMMMCCCSSBBSBBBBCCCHHHHSSHHHHSSSHHSHHHSSHHAAAAAAAAPPP
PPPAAAAAAAHHHHHHHHHHHHHHHHHCACCDCBBBHHBSSSMPPPPPPPMMMMCCSBBBBBBCHHHHHHHHHHHHCCCCSSCBHHHAAAAAAAAAAPPP
PPPAAAAAAHHHHHHHHHHHHHHSSHHCACCACBBHHHBSSMMPPPPPPPPPPMMCCSBBBBHCUHHHHHHAAHSHCCHHSCCBBBBAAAAAAAAAAPPP
PPPASAAAHHHHHHHSSHHHHHHSSCCCACCACBHHHBBSMMPPPPPPPPPPPPMMCSBBXCCCCHHSSSSSSSSSSCHSSCBBBBBAAAAAAAAAAPPP
PPPASAAAHHHHHHHHHHHHHHHHCHBCDUACCBBBBBSSMPPPPPPPPPPPPPPMMCBBBCCDCHHHHHHHHHHCCCHSAXCSBBBDAAAAAAAAAPPP
PPPSAAAHHHSHHHHHHSSSHHHHCHHCCCCACBBBBSSMMPPPPPPPPPPPPPPPMCSBBBBBHHHHHHAAHHHCCHHSACCDAAAAAAAAAAAAAPPP
PPPAAAASHHHHHHHHHHHHHHSCCBHBBHBHAAASSSMMPPPPPPPPPPPPPPPPMCSBBBBBSBAAABAAAHHUDHAAAACAACAAAAAAAAAAAPPP
PPPAAAAABBHHBBHHHHHHHSHHBBHHHHHHHBBSSMMPPPPPPPPPPPPPPPPPMCSBBHHBSBBAAAAAAAAAABBAACCCCCAAAAAAAAAAAPPP
PPPAAAASSBBHBBBHHHHHSHHHHHSHHHHHHHBSMMPPPPPPPPPPPPPPPPPPMMCSBHHBHBBACCCAAAAAABBSAACAACAAAAAAAAAAAPPP
PPPAAASSBBHHHBBHBBHBCHBHHHHBHBHBHHSSMPPPPPPPPPPPPPPPPPPPPMCSBHHBHHBBABCCCCCDXBBBSCCUAAAAAAAAAAAAAPPP
PPPAAASBBHBBBBHBBHBBXHBHBBHBHHHHHHSSMPPPPPPPPPPPPPPPPPPPPMCSBHHHBHBBABBBBBCCCCCCCUAAAAAAAAAAAAAAAPPP
PPPAAASBBHBBSSBSSSSBCHBHHHHBHBHSBHSSMPPPPPPPPPPPPPPPPPPPMMCSBHBHBHBBBABBBBBCCBBBAASSAASSAAAAAAAAAPPP
PPPAASSBBSSBBSHBHCCBCHHBHBHHHBHHBHSSMPPPPPPPPPPPPPPPPPPPMCSSBHHHSHHBBABBBBBCCBAASHSSAASSAAAAAAAAAPPP
PPPAASSBBSSBBSBHBCCSSHHBHHHHHHHHHSSSMMPPPPPPPPPPPPPPPPPPMMCSBHHBBHHHBBAABBBXDAASHHSSASAAAAAAHHAAAPPP
PPPAASSBBSSAAASSBCBHHHSHHBHBBHSHHHSSSMMMPPPPPPPPPPPPPPPPPMCSBHHBBHBHBBAAAAAAADUBBBAASSSAAAAAHHHAAPPP
PPPAASSDBBSAHABBHCBSSSSHHHHHHSHBBHHSSSSMMPPPPPPPPPPPPPPPPMCSBHHBBHHHHBBAXSSSSHBBAABBHHBBAAAAASAAAPPP
PPPAASSBBBSAAABHBCSSBSSSSSSBBSHBCCCCCCDCMMPPPPPPPPPPPPPPPMCSBHBBHHBBHHBBASBHHHBAABBBBHBSBAAAAAAAAPPP
PPPAAASBBBBBBBABSUDAAAAABSSSSAAHXDBSSSUCCMMPPPPPPPPPPPPPPMCSBBBHHBBBBHHBBAAHXDAABBBHHHHBSSAAAAAAAPPP
PPPAAASSBBHHHBHAAAAACCBBAAAAABBAAAAAASBBCCMMMMPPPPPPPPPPPMCSBHBSSBBHBBHSSSBAAAABBBHHHHHBBSAAAAAAAPPP
PPPAAASSBBBBHBHHHDUCACCBBBBBBBBBDXHHSASSBCCCCMMMMMPPPPPPPMCSBBBBSBSBBBBBBSBHDUBBBHHHHHBBBBAAAAAAAPPP
PPPAAAAASSBBHBHCXCCCBACBBBBBBBBHHCHHHASSSBBCCMMMMMMMMMPPMMCSHHSSSSSSSBBBBSHHHBBBBSSHHBBBBAAAAAAAAPPP
PPPAAAAAASSBBBSCCCCCBACBBBBBBHHHHCHHHSAASSBBCMCCCCMSSMMMMCCSHHHSSHSSSSBBBSBHHSHHHSSBBBBBAAAAAAAAAPPP
PPPAAAAAAASBBBSSSBSSSACCBBHHHHHSSCSSHHHSAAAAAMCXDCMBBASSCSSSSHHSSHHHSSSSSBBBBBHHHHBBBBBSAAAAAAAAAPPP
PPPAAAAAAAASSBSSSBBSSSACBHHHSSHSSCSSSHHHAAAAAMCDXBMBBAHHHSSSSHHSSHHHHHSSBBDBBBBHHHBBBSAAAAAAAAAAAPPP
PPPAAAAAAAAAASBBBBBBBBACBHSHSHSSCHCSSHHHHAAAMMSSCSMMAASSHHHHHCCCCCCCCCCXCCCCCXBBHBBBBAAAAAAAAAAAAPPP
PPPAAAAAAAAAASBBBBBSSBACSHCCCCCCHCHCSHHHHHAMMUSSCSSMMAASSHHHHCSSHHHHSSSCCACBBBBBSBBBSAAAAAAAAAAAAPPP
PPPAAAAAAAAAASBBBBBBSBACCSCBDBXHSHSCSSHHHHAMSCCXDCCUMSASSSSSSCSSSSSSSDSSBBBBBBBBBSSSAAAAAAAAAAAAAPPP
PPPAAAAAAAAAAAABBBBBBBBACCXBBBHSHSHCCCCCCCSSSSBDXSSSSSSSSSHHSCSSSSSSHHHSBBBBBSSSAAAAAAAAAAAAAAAAAPPP
PPPAAAAAAAAAAAASBBBBBBSSASHHSHSHSSSXHHHHHBAAMMMSCMMMAAAHHHHHSDSSSSHHHHHHBBBBBSAAAAAAAAAAAAAAAAAAAPPP
PPPAAAAAAAAAAASSBBBBBSSSSAASSSBSCCCCHHHBBBBAAAMSCMAAAASSSSSSSHHHSSHSSSSSSSBBAAAAAAAAAAAAAAAAAAAAAPPP
PPPAAAAAAAAAASSCCSBBSSSSSSSASSBBDUDXHHSBBAAAAAMSCMAAABAABBSBSHHHSHHSSSSSSSSSAAAAAAAAAAAAAAAAAAAAAPPP
PPPAAAAAAAAAASHHCBSBSSSSSSSBAAAAAAAAAAAAABBBBAASCXBBBBBCASSXDSSSSHHSSSSSSSSAAAAAAAAAAAAAAAAAAAAAAPPP
PPPAAAAAAAAAASHHCBBSSSSSSSSBBBBBUDXDBBBBBBBBBBCCCCBBBBBCBAAAAASSHHHSSSSSSSSAAAAAAAAAAAAAAAAAAAAAAPPP
PPPAAAAAAAAAASHHCBBASSSSCCCCCCCCCCCBBCCCCBBBBBCBBCBBBBBCBBBDXBAAHHHHHSSSSSAAAAAAAAAAAAAAAAAAAAAAAPPP
PPPAAAAAAAAASHHHCCCBSCCCCSSBBBBBHHHBBCBBCBBBBBCBBCBHHHHCBBBBCBBAAHHHHSSSSSAAAAAAAAAAAAAAAAAAAAAAAPPP
PPPAAAAAAAASSHHHHSCSSCBABSSBBBBSHHHBBCHHCBBBBBCBBCBHHHHCBBBBCBBBCAAAAAAASSAAAAAAAAAAAAAAAAAAAAAAAPPP
PPPAAAAAAAASSHHSSSCCCCSBSAAABBBSHHHBBCHHCCCCCCCSSSSHHHHCBBBBCBBBCAAABBBSAAAAAAAAAAAAAAAAAAAAAAAAAPPP
PPPAAAAAAAASSSHHSSCBBBBBBSBBABBBSHHBBCHSHSSSBHHDSSXHHBACBBBBAABBCAAAABBSAAAAAAAAAAAAAAAAAAAAAAAAAPPP
PPPAAAAAAAACCCSMMMCBBBBBBSBBAABBHHHBBCBSHHSHSBHHBCCCCBBCBBAACABBCCCCCSAAAAAAAAAAAAAAAAAAAAAAAAAAAPPP
PPPAAAAAAAACMUMMDMCSSSBBBSBBBABBABBBBCSSHHHHSBHHHCHHCBBCBABACBBACBBBXAAAAAAAAAAAAAAAAAAAAAAAAAAAAPPP
PPPAAAAAAAACMMMCCCCSBBBBSBBBBABBBBBBBBBHHHHHBBHHHCHHCBBCBAAACBBBCBBAAAAAAAAAAAAAAAAAAAAAAAAAAAAAAPPP
PPPAAAAAAAACCCCCSCSBBBSSSBBBBAABBBBBBBBHHHBBBBHHHCBBXCCCBBAACCCXCAAAAAAAAAAAAAAAAAAAAAAAAAAAAAAAAPPP
PPPAAAAAAAAAASSSSCCSSSSSAAAAAAAAAAAAABBHHHBBBBHHHCBHAAACCCCCCBBBBAAAAAAAAAAAAAAAAAAAAAAAAAAAAAAAAPPP
PPPAAAAAAAAAAAAAAACCCCSSAAAAAAAAAAAAAABHHBBAAHHHHCBBAAAAAAAABBBAAAAAAAAAAAAAAAAAAAAAAAAAAAAAAAAAAPPP
PPPAAAAAAAAAAAAAAAAAAAAAAAAAAAAAAAAAAAAAAAAAAHHHHCHHAAAAAAAAAAAAAAAAAAAAAAAAAAAAAAAAAAAAAAAAAAAAAPPP
PPPAAAAAAAAAAAAAAAAAAAAAAAAAAAAAAAAAAAAAAAAAAUCCCDHAAAAAAAAAAAAAAAAHHAAAAAAAAAAAAAAAAAAAAAAAAAAAAPPP
PPPAAAAAAAAAAAAAAAAAAAAAAAAAAAAAAAAAAAAAAAAAAAAAABHAAAAAAAAAAAAAAAAAAAAAAAAAAAAAAAAAAAAAAAAAAAAAAPPP
PPPAAAAAAAAAAAAAAAAAAAAAAAAAAAAAAAAAAAAAAAAAAAAAAAAAAAAAAAAAAAAAAAAAAAAAAAAAAAAAAAAAAAAAAAAAAAAAAPPP
PPPAAAAAAAAAAAAAAAAAAAAAAAAAAAAAAAAAAAAAAAAAAAAAAAAAAAAAAAAAAAAAAAAAAAAAAAAAAAAAAAAAAAAAAAAAAAAAAPPP
PPPAAAAAAAAAAAAAAAAAAAAAAAAAAAAAAAAAAAAAAAAAAAAAAAAAAAAAAAAAAAAAAAAAAAAAAAAAAAAAAAAAAAAAAAAAAAAAAPPP
PPPAAAAAAAAAAAAAAAAAAAAAAAAAAAAAAAAAAAAAAAAAAAAAAAAAAAAAAAAAAAAAAAAAAAAAAAAAAAAAAAAAAAAAAAAAAAAAAPPP
PPPPPPPPPPPPPPPPPPPPPPPPPPPPPPPPPPPPPPPPPPPPPPPPPPPPPPPPPPPPPPPPPPPPPPPPPPPPPPPPPPPPPPPPPPPPPPPPPPPP
PPPPPPPPPPPPPPPPPPPPPPPPPPPPPPPPPPPPPPPPPPPPPPPPPPPPPPPPPPPPPPPPPPPPPPPPPPPPPPPPPPPPPPPPPPPPPPPPPPPP
PPPPPPPPPPPPPPPPPPPPPPPPPPPPPPPPPPPPPPPPPPPPPPPPPPPPPPPPPPPPPPPPPPPPPPPPPPPPPPPPPPPPPPPPPPPPPPPPPPPP
1111111111111111111111111111111111111111111111111111111111111111111111111111111111111111111111111111
1111111111111111111111111111111111111111111111111111111111111111111111111111111111111111111111111111
1111111111111111111111111111111111111111111111111111111111111111111111111111111111111111111111111111
1111111111111111111111111111111111111111111111111111111111111111111111111111111111111166666666666111
1111111111111111111111111111111111111111111111111111111111111111111111111111111111111666666666666111
1111111111111111111111111111111111111111111111111111111111111111111111111111111111116666666666666111
1111111111111111111111111111111111111111111111111111111111111111111111111111111111116666666666666111
1111111111111111111111111111111111111111111111111111111111111111111111111111111111116666666666666111
1111111111111111111111111111111111111111111114111111111111111111111111111111111111116666666666666111
1111111111111111111111111111111111111111111122211111111111111111111111111111111111166666666666666111
1111111111111111111111121111111111111111112221221111212222211111111111111111111111666666666666666111
1111111111111111111112222111111111111111222212222233333333222222221111111111111111666666666666666111
1111111111111111111144444444441111111555555222223445555555333322221111111111111116666666666666666111
1111111111111111144444444444444111155555555232234555555555555333222211111111111116666666666666666111
1111111111111111444444444444442111555555555332245555555555555444322211111111111116666666666666666111
1111111111111111444445555514422215555555555333555555555555555555332111111111111116666666666666666111
1111111111111111444445545555555425555555555535555555555555555555553211111111111116666666666666666111
1111111111111444444444444444444444445555555555555555555555555555555321111111111116666666666666666111
1111111111111144444444444444444444445555555555555555555555555555555442111132111116666666666666666111
1111111111111144444444444444444444444555555555555555555555555555555554221111111111666666666666666111
1111111111111122244444444444444444444555555555555555555555555555555555422111111111166666666666666111
1111111111111222221111111111111144444444455555555555555556655555555555222111111111116666666666666111
1111111111112222222222222222222222444444455555555115544456655555555533222111111111116666666666666111
1111111111122222222222222222222222224444435555555555544466666555555333332233333333116666666666666111
1111111111122222222222223322222222222123333343355555555566666555555333333333333333311666666666666111
1111111111122222222222223332222222222223333343355555555666666655555344433333333333333666666666666111
1111111111112222233221123333442222222223333443343555555666666655555344434433333333333666666666666111
1111111111112222233211112113441122222223333444333555555666666655555344334333333333344666666666666111
1111111111112222222211112111221122222222333444333555555666666655555344433333443344446666666666666111
1111111111112222222211112111222222222222333444334455555666666555555343333344433444556666666666666111
1111111111222222222221122112222222221232333444334455555666666555555344333444334444556666666666666111
1111111111122222222222222223222222233332333344334455555566665555553343343343344333336666666666666111
1111111111122222222222222222222242222332333333334455555556655555553333443343333333333666666666666111
1111111111112222222222222222222222222332333333334455555555555555532233433343333333443442266666666111
1111111111111222222222222222111222222223333333335555555555555555532223333333333222455222226666666111
1111112111111222222221111111122222222222222333335555555555555555322222333334433222455222266666666111
1111112211111221222212222222222222222222222223333333555555555553222222223333444424422222266666666111
1111111111111122222222222222222222222222222222333333555555554433222222223333222122222225666666666111
1111111111111222222222222222222222223332222222222223545555554222222222233333322222222225666666666111
1112111111111112222111111111222233333333332222222222245555532222222222222133322222222225566666666111
1112111111111112222222222222222233333333332222222233233533322222222212212233333333312222556666666111
1112111111111112222222222222222233333333322222222333322332222222222122221111111111333322544466661111
1111111111111122222222222222222233333333322222222332322222222222222222222222222221113333444446611111
1111111111222222222222222222222223333332222222222332323322222222221222223344422333211111114461111111
1111111112222222222344445442222223333332224234444233323333222222222222233345424443222223331111111111
1111111112222222222322445442222223333332244554666442222233222222222222232244424541111133331111111111
1111111111215444444444444442144552333332246566616664442223222222112222232222224444221133311111111111
1111111111444444444444444442144552433222446111111166664423322221112222234422233344222221111111111111
1111111114444444444444455442144452442222466111111111166443322211112222233423333342221221111111111111
1111111144444445544444455332144452442224661111111111116643331111113332233425332442222221111111111111
1111111144444444444444443122144552222244611111111111111664331111113432233422222412222222111111111111
1111111244544444455544443234344552222446611111111111111164333222113332114422222412221111111111111111
1111111144444444444444222334422255524466111111111111111164333322221111111122221111211211111111111111
1111111122442244444442422444522233344661111111111111111164343333222111111111111112222211111111111111
1111111112222224444423442345522233346611111111111111111166423333222112111111111111211211111111111111
1111111122222223332223342222332243346111111111111111111116423333322112222222211112221111111111111111
1111111222333233333223342233333243346111111111111111111116424443322211222122222222111111111111111111
1111111222444444444423442333333224446111111111111111111166423343322221122222222211111111111111111111
1111111222555544444422233333335522246111111111111111111164123343322221112222221111111111111111111111
1111111222555544444422244433344522246611111111111111111166423444222222111222211222111111111112111111
1111111222555544333234244444444522244666111111111111111116424224222222111111122211111111111112211111
1111111222555543333334224444444522224446611111111111111116424444332222211122221111244444111111111111
1111111222555543233444222244425522111155661111111111111116423333333222221112221112243334411111111111
1111111222555543333222222222222222111155566111111111111116423333333222331111111122333333421111111111
1111111122555543333222222222222222222155546666111111111116423333233322333221111222333344421111111111
1111111122444443333222223333332222222255544336666611111116422222222222333333222221333342221111111111
1111111112333333333322232222232332333244414336666666661166422555555522233333312223333422211111111111
1111111111123333333332332222233332343222444226555564466664422222222522223333332222222222111111111111
1111111111122332333332232222223332343332222226555564444442225432234522222333332222222221111111111111
1111111111111133332331232222222332344332222226555561111222222222222535222233312222222111111111111111
1111111111111111133311232222222233334233222266444466112222252555555535322233322444222111111111111111
1111111111111111111111232222222233333223222663444436611222252522222225222222222334221111111111111111
1111111111111111111111232222222233323323242633444433621222252535555555222222233314221111111111111111
1111111111111111111111123222222233332332242233444433222222252522222222222222231111111111111111111111
1111111111111111111111222332222233333233352266633666222112252555555522222222111111111111111111111111
1111111111111111111112222223222223333322442222633622212222252322222333342112111111111111111111111111
1111111111111112221122222222333332333224432222633622222222255555555534444111111111111111111111111111
1111111111111122212122222222222222222224322222233222222122222222222234444411111111111111111111111111
1111111111111122211222222222222222222244222222222222222222222222222244444411111111111111111111111111
1111111111111122222222222222222222232444222222221222221122222222222224444111111111111111111111111111
1111111111112222222222222222222222333455422222221222224332222222222224444111111111111111111111111111
1111111111112222122222222222222223333454422222221222224334222222211111111111111111111111111111111111
1111111111112333333322222111222223333444422222222222224314222222211111111111111111111111111111111111
1111111111113333344421233221122222333444412121222222222443332122211111111111111111111111111111111111
1111111111113333344421233222111222333444421213333333322223332122222221111111111111111111111111111111
1111111111113333344522233222111122233444422213333333322233332222211111111111111111111111111111111111
1111111111111333344521233111111122222212222213333333322233332222211111111111111111111111111111111111
1111111111112222333322222111111112222222121113333331522223332222111111111111111111111111111111111111
1111111111111111111112221111111111111222221113333333111222222221111111111111111111111111111111111111
1111111111111111111111111111111111111122211113333333111111111111111111111111111111111111111111111111
1111111111111111111111111111111111111111111113333321111111111111111111111111111111111111111111111111
1111111111111111111111111111111111111111111114333321111111111111111111111111111111111111111111111111
1111111111111111111111111111111111111111111111111111111111111111111111111111111111111111111111111111
1111111111111111111111111111111111111111111111111111111111111111111111111111111111111111111111111111
1111111111111111111111111111111111111111111111111111111111111111111111111111111111111111111111111111
1111111111111111111111111111111111111111111111111111111111111111111111111111111111111111111111111111
1111111111111111111111111111111111111111111111111111111111111111111111111111111111111111111111111111
1111111111111111111111111111111111111111111111111111111111111111111111111111111111111111111111111111
1111111111111111111111111111111111111111111111111111111111111111111111111111111111111111111111111111
1111111111111111111111111111111111111111111111111111111111111111111111111111111111111111111111111111
