86
86
PPPPPPPPPPPPPPPPPPPPPPPPPPPPPPPPPPPPPPPPPPPPPPPPPPPPPPPPPPPPPPPPPPPPPPPPPPPPPPPPPPPPPP
PPPPPPPPPPPPPPPPPPPPPPPPPPPPPPPPPPPPPPPPPPPPPPPPPPPPPPPPPPPPPPPPPPPPPPPPPPPPPPPPPPPPPP
PPPPPPPPPPPPPPPPPPPPPPPPPPPPPPPPPPPPPPPPPPPPPPPPPPPPPPPPPPPPPPPPPPPPPPPPPPPPPPPPPPPPPP
PPPDDDDDDDDDDDDDDDDDDDDDDDDDDDDSSSSSSSSXCCUXCCUSSSSSSSSDDDDDDDDDDDDDDDDDDDDDDDDDDDDPPP
PPPDDDDDDDDDDDDDDDDDDDDDDDDDDDDSSSSSSSSCCCCCCCCSSSSSSSSDDDDDDDDDDDDDDDDDDDDDDDDDDDDPPP
PPPDDDDDDDDDDDDDDDDDDDDDDDDDDDDSSSSSSSSCCCCCCCCSSSSSSSSDDDDDDDDDDDDDDDDDDDDDDDDDDDDPPP
PPPDDDDDDDDDDDDDDDDDDDDDDDDDDDDSSSSSSSSXCCUXCCUSSSSSSSSDDDDDDDDDDDDDXUDDDDDDDDDDDDDPPP
PPPDDDDDDDDDDDDDAADDDDDDDDDDDDDSSSSSSSSAAAAAAAASSSAASSSDDDDDDDDDDDDDCCDDDDDDDDDDDDDPPP
PPPDDDDDDDDDDDAAAAAADDDDDDDDDDDSSSSSSSSAAAAAAAASSAAAASSDDDDDDDDDDDCCCCCCDDDDDDDDDDDPPP
PPPDDDDDDDDDAAAAAAAAAADDDDDDDDDSSSSSSSSAAAAAAAASSAAAASSDDDDDDDDDCCCCCCCCCCDDDDDDDDDPPP
PPPDDDDDDDDAAAAAAAAAAAADDDDDDDDSSSSSSSSAAAAAAAASSSAASSSDDDDDDDDCCCCCCCCCCCCDDDDDDDDPPP
PPPDDDDDDDAAAAAAAAAAAAAADDDDDDDSSSSSSSSAAAAAAAASSSSSSSSDDDDDDDCCCCCCCCCCCCCCDDDDDDDPPP
PPPDDDDDDAAAAAAAAAAAAAAAADDDDDDSSSSSSSSAAAAAAAASSSSSSSSDDDDDDCCCCCCCCCCCCCCCCDDDDDDPPP
PPPDDDDDDAAAAAAAAAAAAAAAADDDDDDSSSSSSSSAAAAAAAASSSSSSSSDDDDDDCCCCCCCCCCCCCCCCDDDDDDPPP
PPPDDDDDAAAAAAAAAAAAAAAAAADDDDDSSSSSSSSAAAAAAAASSSSSSSSDDDDDCCCCCCCCCCCCCCCCCCDDDDDPPP
PPPDDDDDAAAAAAAAAAAAAAAAAADXCCUABBAAMMAAAAAAAAASSSSSSSSDDDDDCCCCCCCCCCCCCCCCCCDDDDDPPP
PPPDDDDAAAAAAAAAAAAAAAAAAAACCCCBBBBMMMMAAAAAAAASSSXUSSSDDDXCCCCCCCCCCCCCCCCCCCCUDDDPPP
PPPDDDDAAAAAAAAAAAAAAAAAAAACCCCBBBBMMMMAAAAAAAASSSXUSSSDDDXCCCCCCCCCCCCCCCCCCCCUDDDPPP
PPPDDDDDAAAAAAAAAAAAAAAAAADXCCUABBAAMMAAAAAAAAASSSSSSSSDDDDDCCCCCCCCCCCCCCCCCCDDDDDPPP
PPPDDDDDAAAAAAAAAAAAAAAAAADDDDDSSSSSSSSAAAAAAAASSSSSSSSDDDDDCCCCCCCCCCCCCCCCCCDDDDDPPP
PPPDDDDDDAAAAAAAAAAAAAAAADDDDDDSSSSSSSSAAAAAAAASSSSSSSSDDDDDDCCCCCCCCCCCCCCCCDDDDDDPPP
PPPDDDDDDAAAAAAAAAAAAAAAADDDDDDSSSSSSSSAAAAAAAASSSSSSSSDDDDDDCCCCCCCCCCCCCCCCDDDDDDPPP
PPPDDDDDDDAAAAAAAAAAAAAADDDDDDDSSSSSSSSAAAAAAAASSSSSSSSDDDDDDDCCCCCCCCCCCCCCDDDDDDDPPP
PPPDDDDDDDDAAAAAAAAAAAADDDDDDDDSSSSSSSSAAAAAAAASSSSSSSSDDDDDDDDCCCCCCCCCCCCDDDDDDDDPPP
PPPDDDDDDDDDAAAAAAAAAADDDDDDDDDSSSSSSSSAAAAAAAASSSSSSSSDDDDDDDDDCCCCCCCCCCDDDDDDDDDPPP
PPPDDDDDDDDDDDAAAAAADDDDDDDDDDDSSSSSSSSAAAAAAAASSSSSSSSDDDDDDDDDDDCCCCCCDDDDDDDDDDDPPP
PPPDDDDDDDDDDDDDAADDDDDDDDDDDDDSSSSSSSSAAAAAAAASSSSSSSSDDDDDDDDDDDDDCCDDDDDDDDDDDDDPPP
PPPDDDDDDDDDDDDDDDDDDDDDDDDDDDDSSSSSSSSAAAAAAAASSSSSSSSDDDDDDDDDDDDDXUDDDDDDDDDDDDDPPP
PPPDDDDDDDDDDDDDDDDDDDDDDDDDDDDSSSSSSSSAAAAAAAASSSSSSSSDDDDDDDDDDDDDDDDDDDDDDDDDDDDPPP
PPPDDDDDDDDDDDDDDDDDDDDDDDDDDDDSSSSSSSSAAAAAAAASSSSSSSSDDDDDDDDDDDDDDDDDDDDDDDDDDDDPPP
PPPDDDDDDDDDDDDDDDDDDDDDDDDDDDDSSSSSSSSAAAAAAAASSSSSSSSDDDDDDDDDDDDDDDDDDDDDDDDDDDDPPP
PPPSSSSSSSSSSSSSSSSSSSSSSSSSSSSSSSSSSSSAAAAAAAASSSSSSSSSSSSSSSSSSSSCCCCSSSSSSSSSSSSPPP
PPPSSSSSSSSSSSSSSSSSSSSSSSSSSSSSSSSSSSSAAAAAAAASSSSSSSSSSSSSSSSSSSSCCCCSSSSSSSSSSSSPPP
PPPSSSSSSSSSSSSSSSSSSSSSSSSSSSSSSSSSSSSAAAAAAAASSSSSSSSSSSSSSSSSSSSCCCCSSSSSSSSSSSSPPP
PPPSSSSSSSSSSSSSXUSSSSSSSSSSSSSSSSSSSSSAAAAAAAASSSSSSSSSSSSSSSSSSSSCXUCSSSSSSSSSSSSPPP
PPPSSSSSSSSSSSSSXUSSSSSSSSSSSSSSSSSPAAAAAAAAAAAAAAPSSSSSSSSSSSSSSSSCXUCSSSSSSSSSSSSPPP
PPPSSSSSSSSSSSSSSSSSSSSSSSSSSSSSSSSMPAAAAAAAAAAAAPCSSSSSSSSSSSSSSSSCCCCSSSSSSSSSSSSPPP
PPPSSSSSSSSSSSSSSSSSSSSSSSSSSSSSSSSMMPAAAAAAAAAAPCCSSSSSSSSSSSSSSSSCCCCSSSSSSSSSSSSPPP
PPPSSSSSSSSSSSSSSSSSSSSSSSSSSSSSSSSMMMPAAAAAAAAPCCCSSSSSSSSSSSSSSSSCCCCSSSSSSSSSSSSPPP
PPPSSSSMMMMMMMMMMMMMMMMMMMMMMMMMMMMMMMMPAAAAAAPCCCCCCCCCCCCCCCCCCCCCCCCCCCCCCCCSSSSPPP
PPPSSSSMMMMMMMMMMMMMMMMMMMMMMMMMMMMMMMMMPAAAAPCCCCCCCCCCCCCCCCCCCCCCCCCCCCCCCCCSSSSPPP
PPPSSSSMMMMMMMMMMMMMMMMMMMMMMMMMMMMMMMMMMPAAPCCCCCCCCCCCCCCCCCCCCCCCCCCCCCCCCCCSSSSPPP
PPPSUXSMMMMMMMMMMMMMMMMMMMMMMMMMMMMMMMMMMMPPCCCCCCCCCCCCCCCCCCCCCCCCCCCCCCCCCCCSUXSPPP
PPPSUXSMMMMMMMMMMMMMMMMMMMMMMMMMMMMMMMMMMMPPCCCCCCCCCCCCCCCCCCCCCCCCCCCCCCCCCCCSUXSPPP
PPPSSSSMMMMMMMMMMMMMMMMMMMMMMMMMMMMMMMMMMPHHPCCCCCCCCCCCCCCCCCCCCCCCCCCCCCCCCCCSSSSPPP
PPPSSSSMMMMMMMMMMMMMMMMMMMMMMMMMMMMMMMMMPHHHHPCCCCCCCCCCCCCCCCCCCCCCCCCCCCCCCCCSSSSPPP
PPPSSSSMMMMMMMMMMMMMMMMMMMMMMMMMMMMMMMMPHHHHHHPCCCCCCCCCCCCCCCCCCCCCCCCCCCCCCCCSSSSPPP
PPPSSSSSSSSSSSSMMMMSSSSSSSSSSSSSSSSMMMPHHHHHHHHPCCCSSSSSSSSSSSSSSSSSAASSSSSSSSSSSSSPPP
PPPSSSSSSSSSSSSMMMMSSSSSSSSSSSSSSSSMMPHHHHHHHHHHPCCSSSSSSSSSSSSSSSSAAAASSSSSSSSSSSSPPP
PPPSSSSSSSSSAASMMMMSSSSSSSSSSSSSSSSMPHHHHHHHHHHHHPCSSSSSSSSSSSSSSSSAAAASMMSSSSSSCCUPPP
PPPSSSSSSSSAAAAMXUMSSSSSSSSSSSSSSSSPHHHHHHHHHHHHHHPSSSSSSSSSSSSSSSSSAASMMMMSSSSCCCCPPP
PPPSSSSSSSSAAAAMXUMSSSSSSSSSSSSSSSBBSSSHHHHHHHHSSSSSSSSSSSSSSSSSSSSSBBSMMMMSSSSCCCCPPP
PPPSSSSSSSSSAASMMMMSSSSSSSSSSSSSSBBBBSSHHHHHHHHSSSSSSSSSSSSSSSSSSSSBBBBSMMSSSSSSCCXPPP
PPPSSSSSSSSSSSSMMMMSSSSSSSSSSSSSSBBBBSSHHHHHHHHSSSSSSSSSSSSSSSSSSSSBBBBSSSSSSSSSSSSPPP
PPPSSSSSSSSSSSSMMMMSSSSSSSSSSSSSSSBBSSSHHHHHHHHSSSSSSSSSSSSSSSSSSSSSBBSSSSSSSSSSSSSPPP
PPPDDDDDDDDDDDDDDDDDDDDDDDDDDDDSSSSSSSSHHHHHHHHSSSSSSSSDDDDDDDDDDDDDDDDDDDDDDDDDDDDPPP
PPPDDDDDDDDDDDDDDDDDDDDDDDDDDDDSSSSSSSSHHHHHHHHSSSSSSSSDDDDDDDDDDDDDDDDDDDDDDDDDDDDPPP
PPPDDDDDDDDDDDDDDDDDDDDDDDDDDDDSSSSSSSSHHHHHHHHSSSSSSSSDDDDDDDDDDDDDDDDDDDDDDDDDDDDPPP
PPPDDDDDDDDDDDDDDDDDDDDDDDDDDDDSSSSSSSSHHHHHHHHSSSSSSSSDDDDDDDDDDDDDDDDDDDDDDDDDDDDPPP
PPPDDDDDDDDDDDDDMMDDDDDDDDDDDDDSMMSSMMSHHHHHHHHSSSSSSSSDDDDDDDDDDDDDHHDDDDDDDDDDDDDPPP
PPPDDDDDDDDDDDMMMMMMDDDDDDDDDDDMMMMMMMMHHHHHHHHSSSSSSSSDDDDDDDDDDDHHHHHHDDDDDDDDDDDPPP
PPPDDDDDDDDDMMMMMMMMMMDDDDDDDDDMMMMMMMMHHHHHHHHSSSSSSSSDDDDDDDDDHHHHHHHHHHDDDDDDDDDPPP
PPPDDDDDDDDMMMMMMMMMMMMDDDDDDDDSMMSSMMSHHHHHHHHSSSSSSSSDDDDDDDDHHHHHHHHHHHHDDDDDDDDPPP
PPPDDDDDDDMMMMMMMMMMMMMMDDDDDDDSSSSSSSSHHHHHHHHSSSSSSSSDDDDDDDHHHHHHHHHHHHHHDDDDDDDPPP
PPPDDDDDDMMMMMMMMMMMMMMMMDDDDDDSSSSSSSSHHHHHHHHSSSSSSSSDDDDDDHHHHHHHHHHHHHHHHDDDDDDPPP
PPPDDDDDDMMMMMMMMMMMMMMMMDDDDDDSSSSSSSSHHHHHHHHSSSSSSSSDDDDDDHHHHHHHHHHHHHHHHDDDDDDPPP
PPPDDDDDMMMMMMMMMMMMMMMMMMDDDDDSSSSSSSSHHHHHHHHSSSSSSSSDDDDDHHHHHHHHHHHHHHHHHHDDDDDPPP
PPPDDDDDMMMMMMMMMMMMMMMMMMDDDDDSSSSSSSSHHHHHHHHHHHHHHHHDDDDDHHHHHHHHHHHHHHHHHHDDDDDPPP
PPPDDDDMMMMMMMMMMMMMMMMMMMMDDDDSSSUXSSSHHHHHHHHHHHUXHHHDDDDHHHHHHHHHHHHHHHHHHHHDDDDPPP
PPPDDDDMMMMMMMMMMMMMMMMMMMMDDDDSSSUXSSSHHHHHHHHHHHUXHHHDDDDHHHHHHHHHHHHHHHHHHHHDDDDPPP
PPPDDDDDMMMMMMMMMMMMMMMMMMDDDDDSSSSSSSSHHHHHHHHHHHHHHHHDDDDDHHHHHHHHHHHHHHHHHHDDDDDPPP
PPPDDDDDMMMMMMMMMMMMMMMMMMDDDDDSSSSSSSSHHHHHHHHSSSSSSSSDDDDDHHHHHHHHHHHHHHHHHHDDDDDPPP
PPPDDDDDDMMMMMMMMMMMMMMMMDDDDDDSSSSSSSSHHHHHHHHSSSSSSSSDDDDDDHHHHHHHHHHHHHHHHDDDDDDPPP
PPPDDDDDDMMMMMMMMMMMMMMMMDDDDDDSSSSSSSSHHHHHHHHSSSSSSSSDDDDDDHHHHHHHHHHHHHHHHDDDDDDPPP
PPPDDDDDDDMMMMMMMMMMMMMMDDDDDDDSSSSSSSSHHHHHHHHSSSSSSSSDDDDDDDHHHHHHHHHHHHHHDDDDDDDPPP
PPPDDDDDDDDMMMMMMMMMMMMDDDDDDDDSSSSSSSSHHHHHHHHSSSSSSSSDDDDDDDDHHHHHHHHHHHHDDDDDDDDPPP
PPPDDDDDDDDDMMMMMMMMMMDDDDDDDDDSSSSSSSSHHHHHHHHSSSSSSSSDDDDDDDDDHHHHHHHHHHDDDDDDDDDPPP
PPPDDDDDDDDDDDMMMMMMDDDDDDDDDDDSSSSSSSSHHHHHHHHSSSSSSSSDDDDDDDDDDDHHHHHHDDDDDDDDDDDPPP
PPPDDDDDDDDDDDDDMMDDDDDDDDDDDDDSSSSSSSSHHHHHHHHSSSSSSSSDDDDDDDDDDDDDHHDDDDDDDDDDDDDPPP
PPPDDDDDDDDDDDDDDDDDDDDDDDDDDDDSSSBBSSSSSSSSSSSSSSSSSSSDDDDDDDDDDDDDDDDDDDDDDDDDDDDPPP
PPPDDDDDDDDDDDDDDDDDDDDDDDDDDDDSSBBBBSSSSSUXSSSSSSSSSSSDDDDDDDDDDDDDDDDDDDDDDDDDDDDPPP
PPPDDDDDDDDDDDDDDDDDDDDDDDDDDDDSSBBBBSSSSSUXSSSSSSSSSSSDDDDDDDDDDDDDDDDDDDDDDDDDDDDPPP
PPPDDDDDDDDDDDDDDDDDDDDDDDDDDDDSSSBBSSSSSSSSSSSSSSSSSSSDDDDDDDDDDDDDDDDDDDDDDDDDDDDPPP
PPPPPPPPPPPPPPPPPPPPPPPPPPPPPPPPPPPPPPPPPPPPPPPPPPPPPPPPPPPPPPPPPPPPPPPPPPPPPPPPPPPPPP
PPPPPPPPPPPPPPPPPPPPPPPPPPPPPPPPPPPPPPPPPPPPPPPPPPPPPPPPPPPPPPPPPPPPPPPPPPPPPPPPPPPPPP
PPPPPPPPPPPPPPPPPPPPPPPPPPPPPPPPPPPPPPPPPPPPPPPPPPPPPPPPPPPPPPPPPPPPPPPPPPPPPPPPPPPPPP
00000000000000000000000000000000000000000000000000000000000000000000000000000000000000
00000000000000000000000000000000000000000000000000000000000000000000000000000000000000
00000000000000000000000000000000000000000000000000000000000000000000000000000000000000
00022222222222222222222222222221111111112211221111111112222222222222222222222222222000
00022222222222222222222222222221111111124422442111111112222222222222222222222222222000
00022222222222222222222222222221111111124422442111111112222222222222222222222222222000
00022222222222222222222222222221111111112211221111111112222222222222332222222222222000
00022222222222224422222222222221111111122222222111221112222222222222442222222222222000
00022222222222444444222222222221111111122222222112442112222222222244444422222222222000
00022222222244444444442222222221111111122222222112442112222222224444444444222222222000
00022222222444444444444222222221111111122222222111221112222222244444444444422222222000
00022222224444445544444422222221111111122222222111111112222222444444554444442222222000
00022222244444455554444442222221111111122222222111111112222224444445555444444222222000
00022222244444455554444442222221111111122222222111111112222224444445555444444222222000
00022222444444555555444444222221111111122222222111111112222244444455555544444422222000
00022222444444555555444444212211221122133333333111111112222244444455555544444422222000
00022224444445555555544444424422442244233333333111111112223444444555555554444443222000
00022224444445555555544444424422442244233333333111111112223444444555555554444443222000
00022222444444555555444444212211221122133333333111111112222244444455555544444422222000
00022222444444555555444444222221111111133333333111111112222244444455555544444422222000
00022222244444455554444442222221111111133333333111111112222224444445555444444222222000
00022222244444455554444442222221111111133333333111111112222224444445555444444222222000
00022222224444445544444422222221111111133333333111111112222222444444554444442222222000
00022222222444444444444222222221111111133333333111111112222222244444444444422222222000
00022222222244444444442222222221111111133333333111111112222222224444444444222222222000
00022222222222444444222222222221111111133333333111111112222222222244444422222222222000
00022222222222224422222222222221111111133333333111111112222222222222442222222222222000
00022222222222222222222222222221111111144444444111111112222222222222332222222222222000
00022222222222222222222222222221111111144444444111111112222222222222222222222222222000
00022222222222222222222222222221111111144444444111111112222222222222222222222222222000
00022222222222222222222222222221111111144444444111111112222222222222222222222222222000
00011111111111111111111111111111111111144444444111111111111111111111111111111111111000
00011111111111111111111111111111111111144444444111111111111111111111111111111111111000
00011111111111111111111111111111111111144444444111111111111111111111111111111111111000
00011111111111111111111111111111111111144444444111111111111111111111111111111111111000
00011111111111111111111111111111111055555555555555011111111111111111111111111111111000
00011111111111111111111111111111111505555555555550511111111111111111111111111111111000
00011111111111111111111111111111111550555555555505511111111111111111111111111111111000
00011111111111111111111111111111111555055555555055511111111111111111111111111111111000
00011112222222233333333333344444444555505555550555544444444333333333333222222221111000
00011112222222233333333333344444444555550555505555544444444333333333333222222221111000
00011112222222233333333333344444444555555055055555544444444333333333333222222221111000
00011112222222233333333333344444444555555500555555544444444333333333333222222221111000
00011112222222233333333333344444444555555500555555544444444333333333333222222221111000
00011112222222233333333333344444444555555055055555544444444333333333333222222221111000
00011112222222233333333333344444444555550555505555544444444333333333333222222221111000
00011112222222233333333333344444444555505555550555544444444333333333333222222221111000
00011111111111111111111111111111111555055555555055511111111111111111221111111111111000
00011111111111111111111111111111111550555555555505511111111111111112442111111111111000
00011111111122111111111111111111111505555555555550511111111111111112442122111111221000
00011111111244211111111111111111111055555555555555011111111111111111221244211112442000
00011111111244211111111111111111112211144444444111111111111111111111221244211112442000
00011111111122111111111111111111124421144444444111111111111111111112442122111111221000
00011111111111111111111111111111124421144444444111111111111111111112442111111111111000
00011111111111111111111111111111112211144444444111111111111111111111221111111111111000
00022222222222222222222222222221111111144444444111111112222222222222222222222222222000
00022222222222222222222222222221111111144444444111111112222222222222222222222222222000
00022222222222222222222222222221111111144444444111111112222222222222222222222222222000
00022222222222222222222222222221111111144444444111111112222222222222222222222222222000
00022222222222224422222222222221221122133333333111111112222222222222442222222222222000
00022222222222444444222222222222442244233333333111111112222222222244444422222222222000
00022222222244444444442222222222442244233333333111111112222222224444444444222222222000
00022222222444444444444222222221221122133333333111111112222222244444444444422222222000
00022222224444445544444422222221111111133333333111111112222222444444554444442222222000
00022222244444455554444442222221111111133333333111111112222224444445555444444222222000
00022222244444455554444442222221111111133333333111111112222224444445555444444222222000
00022222444444555555444444222221111111133333333111111112222244444455555544444422222000
00022222444444555555444444222221111111133333333111111112222244444455555544444422222000
00022224444445555555544444422221111111133333333111111112222444444555555554444442222000
00022224444445555555544444422221111111133333333111111112222444444555555554444442222000
00022222444444555555444444222221111111133333333111111112222244444455555544444422222000
00022222444444555555444444222221111111122222222111111112222244444455555544444422222000
00022222244444455554444442222221111111122222222111111112222224444445555444444222222000
00022222244444455554444442222221111111122222222111111112222224444445555444444222222000
00022222224444445544444422222221111111122222222111111112222222444444554444442222222000
00022222222444444444444222222221111111122222222111111112222222244444444444422222222000
00022222222244444444442222222221111111122222222111111112222222224444444444222222222000
00022222222222444444222222222221111111122222222111111112222222222244444422222222222000
00022222222222224422222222222221111111122222222111111112222222222222442222222222222000
00022222222222222222222222222221112211111111111111111112222222222222222222222222222000
00022222222222222222222222222221124421111111111111111112222222222222222222222222222000
00022222222222222222222222222221124421111111111111111112222222222222222222222222222000
00022222222222222222222222222221112211111111111111111112222222222222222222222222222000
00000000000000000000000000000000000000000000000000000000000000000000000000000000000000
00000000000000000000000000000000000000000000000000000000000000000000000000000000000000
00000000000000000000000000000000000000000000000000000000000000000000000000000000000000
