50
50
PPPPPPPPPPPPPPPPPPPPPPPPPPPPPPPPPPPPPPPPPPPPPPPPPP
PPPPPPPPPPPPPPPPPPPPPPPPPPPPPPPPPPPPPPPPPPPPPPPPPP
PPPPPPPPPPPPPPPPPPPPPPPPPPPPPPPPPPPPPPPPPPPPPPPPPP
PPPSSSCSSSCCCCCSCCSCCCSSSCSSSSCSSSSCSSSCCCCSSSSPPP
PPPSCXCCCSCSSSCSSCCCSCCCCCUSCCCCCSSCCCCCCXCCCCCPPP
PPPCCCCSCCCSCCCCCCSSSCSSCCCCCSSSCCCCSCSCSSSSCSCPPP
PPPCSSBBBBBBBBBBBBBBBBBBBBBBBBBBBBBBBBBBBBBBCCCPPP
PPPCCSBHHBBBBSSSSSSSSCCCCSSSSBCSSSSBSSBBBHHBSCSPPP
PPPSCSBHHBCCCCCCCCCCCCBBCSCCCCCCCCCCCCCCCHHBSCCPPP
PPPCCCBHHBCBSSCSBBBCCBBBCCCBBCSBBBCCBSCSCSBBSCSPPP
PPPCSCBHHBCUSSCBHHHBBBSSSCBBBBBBBBSBBSCSCCBBCCSPPP
PPPCSCBBBBCCSCCBBBBBBSSBXCBSSSBSSBBBBSCBSCBBSCSPPP
PPPSSCBBCSBCSBBBBCCCSSSSCCCCCCCSCSBHBBBBSCBBCCCPPP
PPPCCCBSCSSCSBBBSCSCCCCCCCCBBSCCCSBBBBHBCCCBCSCPPP
PPPCSSBSCCCCBBBSCCSBBSSSSCSBBBSSCCSCCCHBCBCBCSCPPP
PPPCCSBSCSBBBBSCCSSBBBBBBCSHHHBBBCCCBCHBSUCBSCCPPP
PPPSCSBSCSBHBSSCSSBHHBBBBCBBBBBBHBSSCCHBBCCBCCSPPP
PPPCCCBBCSBBBCCCSBHHBBSSCCSBBBSBHHBSCSHBCCBBSCCPPP
PPPCXCBBCCBBSCBCSBBBSCSSCSSCSSSSBBBSCSBBCSBBSUCPPP
PPPCSCBSCBBBSCCBBBBSCCCCCCCCBSSSBBBSCSBBCCBBSCCPPP
PPPCCCBCCSBBBSCBBBBCCXSCBBSCCCCUBBSBCCBBSCBBCCSPPP
PPPSCSBBCCCBBSCCBSCCBBBBBSCCSCBBSBSSSCBBBCSBCSSPPP
PPPCCCBBCSBBBSSCSCCBBBBBSCCBSCCCSBBCCCCBBCSBCCCPPP
PPPSCSBSCBBBBCCCCCCBBBSXDUDBDSCSSBSSSCSBSCBBSCSPPP
PPPCCCBSCCCBBCSBBSCCDSSDAAXBBBCCCCCCCCSBCCCBSCSPPP
PPPSCSBSSSCCSCCBBSSCSSCUAADBBSCSSBSSSCCCCBCBSCCPPP
PPPCCCBBSSSCSCSSSBSCCCCDXDUCCCCBBBSSXCSSCCCBSSCPPP
PPPSSCBBSSSCCCUBSBBSCSBBCCBBSSCBBHBSSCBSSCSBSSCPPP
PPPCCCBBSCCCSCCSBHBBCBBSSCSBXCCCBHBCSCBBSCSBCCCPPP
PPPCSSBBSCBBBBCSBHSCCBBDSCCCBSBCBHBCSCBBSCBBSCSPPP
PPPCCCBBSCBBHBCSHHBSCCCCCCDCCCCCBHBCCCBBCCBBSCCPPP
PPPSSCBSSCCBHBCBBBSSCUBSCSSBBCSBBBSSSCBBBCBBSSCPPP
PPPCCCBSSSCBHBCCBSBBSSSSCSBBBSBBBSCCCCBBBCSBSCCPPP
PPPCSSBCCCCBHBSCCSBHBBSSCBBBBBBBSBCSBBBCCCSBCCSPPP
PPPCCCBCSSSBBBBSCCBBBSSSCBSSCBSSSSCSBBBBSCSBSCSPPP
PPPSSCBCCCCCBBBSSCCCCCCCCXSSCSSSCCCSBBBSSCBBSCCPPP
PPPSCCBBSSSCBBSSSCSSSSSSCCCCCCCCCSCBBBSSSCBBCCSPPP
PPPSSCBBCCCCSBBBBCCCBBSSSSBBSSCBBSCBBSSCCCBBSCCPPP
PPPSCCBBCSSSSBBBBBHHHBSSSBBBBSCBBBBBBSSCSBHBCCSPPP
PPPCCSBBCSUSSSSBCCCBBBSSSBSSBBHHHHBBBSSCBHHBSCSPPP
PPPSCCBBCCCCCCCCCBCBSCCCCBSSSBBBCBBSCCCCSSHBCCSPPP
PPPSCSBHHSSSBSSSSSCCSCSSCCCCCCCCCCCCCBSCCCHBCSSPPP
PPPCCCBHHBBBBBBSSBBCCCBBBCBBSCBBBSSSBBBXBHHBCCCPPP
PPPSSCBBBBBBBBBBBBBBBBBBBBBBBBBBBBBBBBBBBBBBSSCPPP
PPPCSCCCSCSCSCCCSCCCCCCCCSSSSSSSSCCCCCCCSCSSCCCPPP
PPPCUCSCCCSCSCSCSCXCSCSSCCCSCSCSCCSCSCSCCCCCCCSPPP
PPPCCCSSSCCCCCSCCCCCSCCSSSCCCCCCCSSSCCSSSSCSUCSPPP
PPPPPPPPPPPPPPPPPPPPPPPPPPPPPPPPPPPPPPPPPPPPPPPPPP
PPPPPPPPPPPPPPPPPPPPPPPPPPPPPPPPPPPPPPPPPPPPPPPPPP
PPPPPPPPPPPPPPPPPPPPPPPPPPPPPPPPPPPPPPPPPPPPPPPPPP
00000000000000000000000000000000000000000000000000
00000000000000000000000000000000000000000000000000
00000000000000000000000000000000000000000000000000
00011211111211212212111121122222222122122122221000
00012221122221212222221122121212121112121122221000
00012211111211222111121111122211111111211122221000
00012144444444444444444444444444444444444444111000
00012144444445444455554444444444444444444444222000
00011144444445444454454444444444455544455554212000
00022244444555554454454444444444555554445554222000
00012145544454544455554455455444554454445544111000
00022245444544454444444555555544554444444544111000
00011145544544454444444455555444555444444444111000
00011144544444444444444445554444455554444444112000
00012144544444444455544544544444445544544544212000
00011144544554444444444544444444444444554544122000
00011144445554544444445544444444444444545544111000
00022144445455544444444444444444444444544544111000
00021144445455544455544445554445544444444444111000
00022144545554544445554445555445544444444444111000
00011144544444544545554544555445544454445444121000
00011145544444445544444554444445444554445544212000
00011144445554445444454444444444445544444554222000
00022244445454445444454333344555455445444454111000
00021244445455445445444322344555454454454444111000
00022245445445445455444322344555444454454444121000
00021145445455455454454333344444444545555544222000
00022245445454454444554444444555445444454444222000
00011145445454454544554454444454444444454444121000
00011244444444454545554555444454445444444444111000
00012144444444554544444444445454445444444444111000
00011144444444444544544445545554445544445544111000
00011145555544444544555545544444444554444554221000
00012144544554444444444444444444444444444554212000
00011144444444444444444445554555554444455544111000
00011144444444544444544444454444444444445444111000
00021244444444555544544444445444444444444444111000
00012144555444455445544444445444545454544454121000
00021144544444444444444454445444455544554554212000
00011144544444555444444545444444555554545454222000
00021244555444544444445444544444455544544454212000
00012144444444555444455555554444545454444444111000
00021244444444445544444444444444444444444444111000
00011144444444444444444444444444444444444444111000
00011211211111211111212111212121112221211111121000
00022211121212111211212111111211212121211111112000
00021211112121111121212121112121112221222111212000
00000000000000000000000000000000000000000000000000
00000000000000000000000000000000000000000000000000
00000000000000000000000000000000000000000000000000
